,finished,duration_sec,sm_use,age,gender_id,ethnic_id,edu,politic_views,aware_sm_res,aware_sm_advan,aware_sm_interact,aware_sm_use,aware_sm_advan_score,aware_sm_interact_score,aware_sm_use_score,ethic_appr,study_1_ethic_acc,study_1_conc,study_1_add_info,study_2_ethic_acc,study_2_conc,study_2_add_info,study_3_ethic_acc,study_3_conc,study_3_add_info,study_4_ethic_acc,study_4_conc,study_4_add_info,design_cont,design_num_users,design_res_purp,design_len_data,design_admin_inter,design_inter_type,design_partic_aware,design_inter_impact,design_type_data,design_add_fac,rank_sci_repro,rank_resp,rank_just,rank_anony,rank_harms,rank_balance,rank_pub_interst,rank_add_fac_1,rank_add_fac_1_pos,rank_add_fac_2,rank_add_fac_2_pos,rank_add_fac_3,rank_add_fac_3_pos
1,True,912.0,Facebook,29.0,Male,Asian - Eastern,Highschool,Slightly liberal,Extremely aware,"['… are large and can contain millions of data points', '… reflect events in real-time and can be collected continuously over time', '… are naturalistic in that they do not require researchers to directly interact with research volunteers', '… often capture social relationships not found using traditional methods (e.g. surveys)']","['Creating fake accounts (""bots"")', 'Secretly changing the content of what users see']","['Political elections (e.g. voting behavior)', 'Economic forecasting', 'Presidential approval ratings', 'Health topics (e.g. spread of diseases)', 'Well-being and economic satisfaction', 'Communication (e.g. spread of opinions and hate-speech)', 'Public sentiment (e.g. environment-related concerns)', 'News consumption (e.g. sharing of misinformation)', 'Social networks']",4,0,9,The scope of the project and actions there in do not cross certain boundaries that may purposefully negatively affect participants as well as legal regulations and standard practices.,Neutral,,,Neutral,,,Neutral,,,Neutral,,,Not at all important,Not at all important,Not at all important,Not at all important,Not at all important,Slightly important,Slightly important,Not at all important,Not at all important,,2.0,7.0,5.0,6.0,4.0,3.0,1.0,,,,,,
2,True,720.0,Twitter,33.0,Male,Mixed race,Highschool,Neutral/ Neither conservative or liberal,Moderately aware,['… are large and can contain millions of data points'],"['Privately messaging users', ""Publicly posting on users' profiles"", 'Secretly changing the content of what users see']","['Political elections (e.g. voting behavior)', 'Economic forecasting', 'Presidential approval ratings', 'Health topics (e.g. spread of diseases)', 'Well-being and economic satisfaction', 'Communication (e.g. spread of opinions and hate-speech)', 'Public sentiment (e.g. environment-related concerns)', 'News consumption (e.g. sharing of misinformation)', 'Social networks']",1,1,9,I think Ethical Approval means that the experiment is gathering data without harm or injury to people.,Completely acceptable,,,Completely acceptable,,,Completely acceptable,,,Neutral,,,Not at all important,Not at all important,Not at all important,Not at all important,Not at all important,Not at all important,Moderately important,Not at all important,Not at all important,the only aspects of social media research that would cause concern for me is saving photographs or imaging data,3.0,5.0,2.0,6.0,1.0,7.0,4.0,,,,,,
3,True,1874.0,Facebook,33.0,Female,Pacific Islander,Bachelor's degree,Very liberal,Extremely aware,"['… are large and can contain millions of data points', '… are naturalistic in that they do not require researchers to directly interact with research volunteers', '… often capture social relationships not found using traditional methods (e.g. surveys)', '… are readily accessible to researchers and easy to collect']","['Privately messaging users', ""Publicly posting on users' profiles"", 'Creating fake accounts (""bots"")', 'Secretly changing the content of what users see']","['Political elections (e.g. voting behavior)', 'Presidential approval ratings', 'Communication (e.g. spread of opinions and hate-speech)', 'News consumption (e.g. sharing of misinformation)', 'Social networks']",2,2,5,Researchers focus on ethical standards towards those they gain data from. They need approval of their approach and receive methods.,Completely acceptable,no concerns i would have loved to partake in this study in terms of watching the results,,Completely acceptable,"going to the poster privately provided opportunity for change without the possibly of increased toxicity from users i prefer this method over commenting the ""correct information""",,Somewhat acceptable,i find this is ethical as long as participants were fully aware of what was being monitored the results are interesting! no concerns,,Somewhat unacceptable,i am uncertain how i feel completely about a researcher creating a fake account however i do understand the desire to protect themselves and to not give away their actions as being part of a study this misinformation needed to be corrected for the public but it opened the original poster to toxicity the op may not have known it was incorrect,the researchers had a purpose in seeing the responses of those interacting with the post i do not agree with how it was done entirely however i do not know a better way to get the results that were desired,Extremely important,Very important,Very important,Extremely important,Moderately important,Very important,Moderately important,Extremely important,Not at all important,"none that i can think of, other than what has been  asked already",7.0,5.0,6.0,3.0,2.0,4.0,1.0,,,,,,
4,True,1264.0,Facebook,73.0,Female,White / Caucasian,Highschool,Slightly conservative,Moderately aware,"['… are large and can contain millions of data points', '… often capture social relationships not found using traditional methods (e.g. surveys)', '… are readily accessible to researchers and easy to collect']","['Creating fake accounts (""bots"")']","['Political elections (e.g. voting behavior)', 'Presidential approval ratings', 'Health topics (e.g. spread of diseases)', 'Communication (e.g. spread of opinions and hate-speech)', 'Public sentiment (e.g. environment-related concerns)', 'News consumption (e.g. sharing of misinformation)']",1,1,6,"I would think that using ""ethical approval"" means that the things others collect on social media sites would need to be honest and moral.  Hopefully, there would be no under-handedness used in collecting information.",Neutral,"i feel if people know they are being judged they will act, speak, or write differently than if they don't know they are being analyzed",,Somewhat acceptable,"i feel as though, in the above case, users had a choice to respond or not so i think it was honest",,Somewhat acceptable,"as long as the facebook users were informed that they would be in a study i feel it is fair  it was up to the users whether they wanted to participate or not  also, they were encouraged, but not actually made to like the facebook study",,Somewhat unacceptable,users were not aware of what was going on so they were possibly more honest in their opinions because they had no idea they were being analyzed,,Moderately important,Moderately important,Extremely important,Very important,Moderately important,Very important,Extremely important,Very important,Very important,reducing any type of hate is always a good thing,7.0,2.0,6.0,3.0,4.0,5.0,1.0,,8.0,,,,
5,True,556.0,Twitter,27.0,Female,Native-American,Highschool,Very liberal,Extremely aware,"['… often capture social relationships not found using traditional methods (e.g. surveys)', '… are readily accessible to researchers and easy to collect']","['Privately messaging users', ""Publicly posting on users' profiles"", 'Creating fake accounts (""bots"")']","['Political elections (e.g. voting behavior)', 'Economic forecasting', 'Presidential approval ratings', 'Health topics (e.g. spread of diseases)', 'Well-being and economic satisfaction', 'Communication (e.g. spread of opinions and hate-speech)', 'Public sentiment (e.g. environment-related concerns)', 'News consumption (e.g. sharing of misinformation)', 'Social networks']",0,3,9,A set of rules of what to do and what to not do.,Completely acceptable,,,Completely acceptable,,,Completely unacceptable,"the web extension being used was invasive, even if it was used with consent the people participating in the study are not educated enough on exactly how much information the web extension was taking",making the source code for the web extension publicly available to have complete transparency over what the extension was doing,Completely acceptable,,,Extremely important,Not at all important,Not at all important,Not at all important,Not at all important,Extremely important,Slightly important,Not at all important,Extremely important,,3.0,1.0,5.0,2.0,4.0,6.0,7.0,,,,,,
6,True,1117.0,Facebook,49.0,Female,Hispanic,Bachelor's degree,Slightly liberal,Slightly aware,"['… are large and can contain millions of data points', '… reflect events in real-time and can be collected continuously over time', '… often capture social relationships not found using traditional methods (e.g. surveys)', '… are readily accessible to researchers and easy to collect']","[""Publicly posting on users' profiles"", 'Creating fake accounts (""bots"")', ""Hacking into users' accounts""]","['Political elections (e.g. voting behavior)', 'Health topics (e.g. spread of diseases)', 'Well-being and economic satisfaction', 'News consumption (e.g. sharing of misinformation)', 'Social networks']",2,1,5,is when the participants have the right to know who was access to their data and what is being done with it.,Somewhat acceptable,,,Somewhat unacceptable,,,Completely acceptable,,,Somewhat acceptable,,,Very important,Moderately important,Extremely important,Very important,Very important,Very important,Very important,Very important,Very important,,7.0,2.0,6.0,4.0,1.0,3.0,5.0,,,,,,
7,True,1862.0,Facebook,53.0,Male,White / Caucasian,Highschool,Slightly conservative,Slightly aware,"['… are large and can contain millions of data points', '… reflect events in real-time and can be collected continuously over time', '… are naturalistic in that they do not require researchers to directly interact with research volunteers', '… often capture social relationships not found using traditional methods (e.g. surveys)', '… are readily accessible to researchers and easy to collect', '… are unaffected by the way social media platforms work']",['None of the above'],"['Political elections (e.g. voting behavior)', 'Presidential approval ratings', 'Communication (e.g. spread of opinions and hate-speech)', 'Public sentiment (e.g. environment-related concerns)', 'News consumption (e.g. sharing of misinformation)']",2,0,5,Verification of some sort that social media users and/or the data being used is not being skewed to support a theory or the results in any way.,Completely unacceptable,"easy enough for an outside government to try copying such a study with the sole purpose of creating much more polarization, hate, etc not that it hasn't been tried and tested perhaps innumerable times by all types of foreign or domestic entities as far as we know no actual study would have really been needed to know that using a type of marketing manipulation could alter the recipients moodlevels of concernanxietyhateetc",,Somewhat acceptable,,"concerns over the possibility of the researchers having their own political agenda yet fake news is a major problem what social media really is when mass sharing news (political news), is simple propaganda from the left and right",Neutral,the researchers seem in some ways to try manipulating political viewpoints in a segment of the population for the sake of science,,Neutral,many of the people that have large political followings on twitter (and many who don't) often know already the news they are sharing is fake it's political partisanship and the spreading of propaganda some might post fake news only to gain more followers (the masses) if they believe it serves that end,,Moderately important,Extremely important,Slightly important,Very important,Moderately important,Extremely important,Extremely important,Extremely important,Very important,na i have already voiced my concerns about researching this in general from this surveys other questions,6.0,7.0,5.0,3.0,2.0,4.0,1.0,a full disclosure of any political organizations of which a researcher belongs to or has donated to within a previous time frame  (such as 4 yrs),8.0,,9.0,,10.0
8,True,448.0,Reddit,29.0,Female,White / Caucasian,Highschool,Slightly liberal,Moderately aware,"['… are large and can contain millions of data points', '… reflect events in real-time and can be collected continuously over time', '… are naturalistic in that they do not require researchers to directly interact with research volunteers', '… often capture social relationships not found using traditional methods (e.g. surveys)', '… are readily accessible to researchers and easy to collect']","['Privately messaging users', ""Publicly posting on users' profiles"", 'Creating fake accounts (""bots"")']","['Political elections (e.g. voting behavior)', 'Economic forecasting', 'Well-being and economic satisfaction', 'Communication (e.g. spread of opinions and hate-speech)', 'Public sentiment (e.g. environment-related concerns)', 'News consumption (e.g. sharing of misinformation)']",3,3,6,"Going through a process of peer review maybe? Like earlier you mentioned creating bot accounts, so maybe making sure the researcher isn’t spreading hate or misinformation ",Completely acceptable,,,Completely acceptable,,,Completely acceptable,,,Somewhat acceptable,,,Very important,Very important,Moderately important,Extremely important,Moderately important,Moderately important,Moderately important,Extremely important,Very important,the possibility of bot accounts spreading misinformation or hate speech just for the purpose of an experiment,7.0,6.0,5.0,4.0,2.0,1.0,3.0,,,,,,
9,True,991.0,Facebook,23.0,Male,White / Caucasian,Bachelor's degree,Neutral/ Neither conservative or liberal,Moderately aware,['… are unaffected by the way social media platforms work'],"[""Publicly posting on users' profiles""]",['Social networks'],-1,1,1,"Social media is a collective term for websites and applications that focus on communication, community-based input, interaction, content-sharing and collaboration.",Neutral,,,Neutral,,,Neutral,,,Neutral,,,Moderately important,Moderately important,Moderately important,Moderately important,Moderately important,Moderately important,Moderately important,Moderately important,Moderately important,"no, i didn't anything like that",5.0,4.0,7.0,2.0,6.0,3.0,1.0,,6.0,,5.0,,8.0
10,True,697.0,Facebook,65.0,Male,Hispanic,Highschool,Very liberal,Moderately aware,"['… are large and can contain millions of data points', '… reflect events in real-time and can be collected continuously over time', '… are naturalistic in that they do not require researchers to directly interact with research volunteers', '… often capture social relationships not found using traditional methods (e.g. surveys)', '… are readily accessible to researchers and easy to collect']","['Privately messaging users', 'Creating fake accounts (""bots"")']","['Political elections (e.g. voting behavior)', 'Presidential approval ratings', 'Health topics (e.g. spread of diseases)', 'Well-being and economic satisfaction', 'Communication (e.g. spread of opinions and hate-speech)', 'Public sentiment (e.g. environment-related concerns)', 'News consumption (e.g. sharing of misinformation)', 'Social networks']",3,2,8,Whether or not something goes against someone's right to privacy online.,Completely acceptable,,i would be interested to know what kind of messages they sent the hate speech users that got them to change their minds,Completely acceptable,"it's perfectly within someone's right to send someone else a message on any platform, therefore i believe this study was acceptable",,Completely acceptable,"people willingly consented to being part of the research study, so i believe the study was completely acceptable",,Completely acceptable,,,Very important,Not at all important,Slightly important,Not at all important,Not at all important,Not at all important,Moderately important,Very important,Not at all important,,5.0,3.0,7.0,4.0,1.0,6.0,2.0,the researchers should not intrude into the user's personal lives,8.0,,,,
11,True,1549.0,Facebook,63.0,Female,White / Caucasian,Highschool,Neutral/ Neither conservative or liberal,Not at all aware,['None of the above'],['None of the above'],['None of the above'],0,0,0,A set of guidelines needs to be followed that allows only allows  ethical questions and research.,Completely unacceptable,the participants were not were of this research study being conducted therefore it is unethical,full disclosure of intent of researchers,Completely unacceptable,this is unethical because those involved were not adequately informed of the researchers intent,full disclosure if research intent,Somewhat unacceptable,,,Completely unacceptable,this study is unethfull disclosure of intent of researchical because they were not informed of the research study,full disclosure of intent of researchers,Extremely important,Moderately important,Extremely important,Moderately important,Extremely important,Moderately important,Extremely important,Moderately important,Extremely important,conducting research without participants knowledge or consent is highly unethical and should not be allowed,7.0,1.0,2.0,5.0,3.0,4.0,6.0,full disclosure of intent of research,8.0,,,,
12,True,843.0,Facebook,50.0,Male,Hispanic,Highschool,Neutral/ Neither conservative or liberal,Moderately aware,"['… often capture social relationships not found using traditional methods (e.g. surveys)', '… are readily accessible to researchers and easy to collect']","['Creating fake accounts (""bots"")', 'Secretly changing the content of what users see']","['Political elections (e.g. voting behavior)', 'Presidential approval ratings', 'Public sentiment (e.g. environment-related concerns)', 'Social networks']",0,0,4,approval to make sure they are following the standards,Somewhat acceptable,,,Somewhat unacceptable,,,Somewhat acceptable,,,Somewhat unacceptable,,,Extremely important,Not at all important,Very important,Slightly important,Slightly important,Moderately important,Very important,Very important,Very important,,6.0,2.0,3.0,1.0,4.0,5.0,7.0,,,,,,
13,True,509.0,Facebook,35.0,Female,White / Caucasian,Master's degree or above,Neutral/ Neither conservative or liberal,Not at all aware,"['… are large and can contain millions of data points', '… are naturalistic in that they do not require researchers to directly interact with research volunteers']","['Privately messaging users', ""Publicly posting on users' profiles"", 'Creating fake accounts (""bots"")']","['Political elections (e.g. voting behavior)', 'Presidential approval ratings', 'Health topics (e.g. spread of diseases)']",2,3,3,Agreeing to do an experiment without being tricked and on your own will,Somewhat acceptable,,,Somewhat acceptable,,,Somewhat unacceptable,,,Neutral,,,Moderately important,Moderately important,Moderately important,Moderately important,Moderately important,Moderately important,Moderately important,Moderately important,Moderately important,,7.0,3.0,4.0,5.0,1.0,6.0,2.0,None,1.0,None,3.0,give results after entire experiment is done,2.0
14,True,1568.0,Facebook,71.0,Male,White / Caucasian,Bachelor's degree,Very liberal,Very aware,"['… are large and can contain millions of data points', '… are readily accessible to researchers and easy to collect']","['Privately messaging users', ""Publicly posting on users' profiles"", 'Creating fake accounts (""bots"")', 'Secretly changing the content of what users see', ""Hacking into users' accounts""]","['Political elections (e.g. voting behavior)', 'Economic forecasting', 'Presidential approval ratings', 'Health topics (e.g. spread of diseases)', 'Well-being and economic satisfaction', 'Communication (e.g. spread of opinions and hate-speech)', 'Public sentiment (e.g. environment-related concerns)', 'News consumption (e.g. sharing of misinformation)', 'Social networks']",0,1,9,"Nothing really, most institutions have a ethical behavior list for show and probably a majority of researchers try to follow it, but results are more important so lip service is given and I’d be surprised if there is any real enforcement. ",Somewhat unacceptable,deceitful and lazy even with the positive result how you get results matter,see comments from previous studies,Somewhat unacceptable,it’s deception no matter how you look at it and it’s lazy as twitter users are not a representative sample of reality,how do you pick a representative sample on a non representative platform,Neutral,"how do you get a representative sample of self selected participants i take surveys here, do i sometimes slant my views away from what i really believe yes, of course, i’m human number of participants does not guarantee quality","since the study is revealed as a study, i think it’s ethical, but mostly nonsensical",Somewhat unacceptable,"i have the same objections as before, it’s deceitful and lazy and twitter is a non representative sample of the public",please see comments from the first study,Very important,Very important,Not at all important,Moderately important,Not at all important,Moderately important,Extremely important,Not at all important,Very important,how do you guarantee a representative sample versus just numbers quality is important,1.0,5.0,7.0,3.0,2.0,6.0,4.0,,1.0,,,,
15,True,721.0,Twitter,38.0,Male,White / Caucasian,Highschool,Neutral/ Neither conservative or liberal,Very aware,"['… are large and can contain millions of data points', '… reflect events in real-time and can be collected continuously over time', '… often capture social relationships not found using traditional methods (e.g. surveys)', '… are readily accessible to researchers and easy to collect', '… are always representative of people’s offline behavior']","['Creating fake accounts (""bots"")', 'Secretly changing the content of what users see', ""Hacking into users' accounts""]","['Political elections (e.g. voting behavior)', 'Economic forecasting', 'Presidential approval ratings', 'News consumption (e.g. sharing of misinformation)', 'Social networks']",1,-1,5,i think that ethical approval means that they are approved for whatever they need to do under the grounds that its ethical meaning not going to do harm or violate any rights of the people.,Somewhat acceptable,,,Somewhat acceptable,,,Somewhat acceptable,,,Somewhat acceptable,,,Moderately important,Very important,Very important,Moderately important,Moderately important,Slightly important,Extremely important,Very important,Very important,the parts i find most important or the sources of the information and the participants knowledge of the study,7.0,2.0,5.0,1.0,3.0,6.0,4.0,,,,,,
16,True,607.0,Facebook,27.0,Male,White / Caucasian,Master's degree or above,Very liberal,Extremely aware,"['… are large and can contain millions of data points', '… reflect events in real-time and can be collected continuously over time', '… are naturalistic in that they do not require researchers to directly interact with research volunteers', '… often capture social relationships not found using traditional methods (e.g. surveys)', '… are readily accessible to researchers and easy to collect']","['Creating fake accounts (""bots"")', 'Secretly changing the content of what users see']","['Political elections (e.g. voting behavior)', 'Presidential approval ratings', 'Health topics (e.g. spread of diseases)', 'Well-being and economic satisfaction', 'Public sentiment (e.g. environment-related concerns)', 'News consumption (e.g. sharing of misinformation)', 'Social networks']",3,0,7,Ethical approval means presenting their research methods to an institutional review board to get approval for funding as well as permission to perform their research.,Somewhat acceptable,,,Somewhat acceptable,,,Completely acceptable,,,Somewhat acceptable,,,Extremely important,Extremely important,Very important,Moderately important,Very important,Very important,Moderately important,Moderately important,Very important,,7.0,1.0,5.0,2.0,4.0,3.0,6.0,,,,,,
17,True,172.0,Reddit,40.0,Male,White / Caucasian,Highschool,Very liberal,Slightly aware,['… are readily accessible to researchers and easy to collect'],"['Creating fake accounts (""bots"")']",['Public sentiment (e.g. environment-related concerns)'],-1,1,1,permission from their sponsors,Neutral,,,Neutral,,,Neutral,,,Neutral,,,Moderately important,Very important,Not at all important,Extremely important,Very important,Very important,Slightly important,Very important,Moderately important,,4.0,3.0,1.0,7.0,6.0,2.0,5.0,,1.0,,3.0,,2.0
18,True,230.0,Facebook,37.0,Female,White / Caucasian,Highschool,Neutral/ Neither conservative or liberal,Not at all aware,"['… reflect events in real-time and can be collected continuously over time', '… are readily accessible to researchers and easy to collect']","['Privately messaging users', ""Publicly posting on users' profiles""]","['Political elections (e.g. voting behavior)', 'Public sentiment (e.g. environment-related concerns)', 'News consumption (e.g. sharing of misinformation)']",0,2,3,Getting approval the proper way ,Somewhat unacceptable,,,Somewhat unacceptable,,,Neutral,,,Somewhat unacceptable,,,Moderately important,Moderately important,Slightly important,Very important,Moderately important,Moderately important,Slightly important,Slightly important,Slightly important,,4.0,7.0,3.0,2.0,5.0,6.0,1.0,,,,,,
19,True,941.0,Facebook,36.0,Male,African-American,Highschool,Slightly liberal,Slightly aware,"['… are large and can contain millions of data points', '… reflect events in real-time and can be collected continuously over time', '… are naturalistic in that they do not require researchers to directly interact with research volunteers', '… often capture social relationships not found using traditional methods (e.g. surveys)', '… are readily accessible to researchers and easy to collect']","['Creating fake accounts (""bots"")', 'Secretly changing the content of what users see']","['Political elections (e.g. voting behavior)', 'Economic forecasting', 'Presidential approval ratings', 'Health topics (e.g. spread of diseases)', 'Well-being and economic satisfaction', 'Communication (e.g. spread of opinions and hate-speech)', 'Public sentiment (e.g. environment-related concerns)', 'News consumption (e.g. sharing of misinformation)', 'Social networks']",3,0,9,I believe it would be the experiment being shown to not violate privacy or cause unintended damage to the participants without their prior consent.,Neutral,"again, not having consent is my issue here even though they did a good thing",,Somewhat unacceptable,"while it looks like no harm was caused the participants in the experiment were not aware of their participation, were not offered any type of compensation and were sent messages without their consent",just informing people about the study,Completely acceptable,,,Neutral,this one is kind of hard because it's actually doing a good thing and providing fact checking and everything is done publicly i think at the end though not knowing you are part of an experiment is wrong,if they had told people they would be part of an experiment,Moderately important,Moderately important,Moderately important,Not at all important,Not at all important,Very important,Extremely important,Moderately important,Moderately important,,4.0,1.0,5.0,2.0,7.0,6.0,3.0,,,,,,
20,True,797.0,Facebook,44.0,Male,Mixed race,Highschool,Slightly conservative,Moderately aware,"['… are large and can contain millions of data points', '… reflect events in real-time and can be collected continuously over time', '… are naturalistic in that they do not require researchers to directly interact with research volunteers', '… often capture social relationships not found using traditional methods (e.g. surveys)', '… are readily accessible to researchers and easy to collect']","[""Publicly posting on users' profiles"", 'Creating fake accounts (""bots"")', 'Secretly changing the content of what users see']","['Political elections (e.g. voting behavior)', 'Presidential approval ratings', 'Health topics (e.g. spread of diseases)', 'Well-being and economic satisfaction', 'Communication (e.g. spread of opinions and hate-speech)', 'Public sentiment (e.g. environment-related concerns)', 'News consumption (e.g. sharing of misinformation)', 'Social networks']",3,1,8,"That their involvement is no way influencing the conversation, and avoids steering sentiment. ",Neutral,,,Neutral,,,Completely acceptable,,,Neutral,,,Very important,Extremely important,Slightly important,Very important,Very important,Moderately important,Very important,Moderately important,Moderately important,,6.0,3.0,7.0,1.0,2.0,4.0,5.0,,,,,,
21,True,452.0,Facebook,44.0,Female,White / Caucasian,Master's degree or above,Slightly liberal,Moderately aware,"['… are large and can contain millions of data points', '… reflect events in real-time and can be collected continuously over time', '… are naturalistic in that they do not require researchers to directly interact with research volunteers', '… often capture social relationships not found using traditional methods (e.g. surveys)', '… are readily accessible to researchers and easy to collect']","['Creating fake accounts (""bots"")', 'Secretly changing the content of what users see']","['Political elections (e.g. voting behavior)', 'Economic forecasting', 'Presidential approval ratings', 'Health topics (e.g. spread of diseases)', 'Well-being and economic satisfaction', 'Communication (e.g. spread of opinions and hate-speech)', 'Public sentiment (e.g. environment-related concerns)', 'News consumption (e.g. sharing of misinformation)', 'Social networks']",3,0,9,It is things like informed consent.,Completely acceptable,"if it's public and within the scope of the app, it seems ethical",,Somewhat acceptable,i am always suspicious of unasked for private messages,,Completely acceptable,"the participants were clearly aware however, them being aware probably changed the results",,Completely acceptable,"it was public and a pretty normal tactic, and it did no personal harm, intended or otherwise",,Extremely important,Very important,Extremely important,Very important,Very important,Extremely important,Extremely important,Extremely important,Extremely important,,5.0,3.0,7.0,4.0,1.0,6.0,2.0,,1.0,,2.0,,3.0
22,True,948.0,Facebook,37.0,Male,White / Caucasian,Highschool,Slightly conservative,Moderately aware,"['… are large and can contain millions of data points', '… reflect events in real-time and can be collected continuously over time', '… are naturalistic in that they do not require researchers to directly interact with research volunteers', '… often capture social relationships not found using traditional methods (e.g. surveys)', '… are readily accessible to researchers and easy to collect']",['Privately messaging users'],"['Political elections (e.g. voting behavior)', 'Economic forecasting', 'Presidential approval ratings', 'Health topics (e.g. spread of diseases)', 'Well-being and economic satisfaction', 'Communication (e.g. spread of opinions and hate-speech)', 'Public sentiment (e.g. environment-related concerns)', 'News consumption (e.g. sharing of misinformation)', 'Social networks']",3,1,9,To make sure that the work they are doing does not violate anyones personal information and is ethical. ,Completely acceptable,i think this is acceptable and i don't have any concerns,it kind of depends on what the replies were i guess i'm not 100% sure if it is ethically acceptable because i don't know what the researchers said i would assume it was ok though,Completely acceptable,i don't have any concerns because the person could just delete the private message if they wanted,,Somewhat acceptable,as long as the people were aware that they would be tracked i think it's fine if there was any deception with that i would be opposed to it,if the browser extension tracked anything besides what is stated it would be unacceptable,Somewhat acceptable,the only concern i have is that they used an automated response system which is kind of like spamming,,Moderately important,Not at all important,Slightly important,Moderately important,Very important,Moderately important,Very important,Slightly important,Slightly important,,6.0,7.0,4.0,2.0,3.0,5.0,1.0,,,,,,
23,True,597.0,Twitter,27.0,Female,White / Caucasian,Bachelor's degree,Very liberal,Moderately aware,"['… are large and can contain millions of data points', '… reflect events in real-time and can be collected continuously over time', '… are naturalistic in that they do not require researchers to directly interact with research volunteers', '… often capture social relationships not found using traditional methods (e.g. surveys)', '… are readily accessible to researchers and easy to collect']","['Privately messaging users', 'Creating fake accounts (""bots"")', 'Secretly changing the content of what users see']","['Political elections (e.g. voting behavior)', 'Presidential approval ratings', 'Health topics (e.g. spread of diseases)', 'Well-being and economic satisfaction', 'Communication (e.g. spread of opinions and hate-speech)', 'Public sentiment (e.g. environment-related concerns)', 'News consumption (e.g. sharing of misinformation)', 'Social networks']",3,1,8,Approval to ensure that the study and methods used in the study will not cause harm to participants,Somewhat unacceptable,i don't like that the study involved engaging in hate speech as welli don't find this super ethical,,Somewhat acceptable,participants didn't consent to being part of the study and weren't debriefed after,,Completely acceptable,,,Somewhat acceptable,"participants didn't consent to the study, but posts were public and posts like these happen all of the time anyway, so i don't think it's that big of a deal",,Very important,Not at all important,Very important,Not at all important,Slightly important,Extremely important,Very important,Very important,Slightly important,,7.0,6.0,5.0,3.0,2.0,1.0,4.0,,,,,,
24,True,776.0,Facebook,60.0,Male,White / Caucasian,Master's degree or above,Slightly liberal,Very aware,"['… are large and can contain millions of data points', '… are readily accessible to researchers and easy to collect']","[""Publicly posting on users' profiles""]","['Political elections (e.g. voting behavior)', 'Economic forecasting', 'Presidential approval ratings', 'Health topics (e.g. spread of diseases)', 'Well-being and economic satisfaction', 'Communication (e.g. spread of opinions and hate-speech)', 'Public sentiment (e.g. environment-related concerns)', 'News consumption (e.g. sharing of misinformation)']",0,1,8,"Ethical approval means the researchers will abide by the code of ethics, namely what is right and wrong, which the institution claims to honor.",Neutral,,interesting idea for a study i'd have to think long and hard about its value i no longer use twitter,Neutral,i don't use twitter because of the bots,,Somewhat acceptable,the people involved knew they were part of a study so this is ethical,,Neutral,,i don't use twitter too many bots,Slightly important,Slightly important,Slightly important,Slightly important,Slightly important,Slightly important,Extremely important,Slightly important,Slightly important,consent of participants is of paramount importance,5.0,1.0,7.0,2.0,6.0,3.0,4.0,,,,,,
25,True,633.0,Reddit,25.0,Female,White / Caucasian,Highschool,Very liberal,Very aware,"['… are large and can contain millions of data points', '… are naturalistic in that they do not require researchers to directly interact with research volunteers', '… often capture social relationships not found using traditional methods (e.g. surveys)']","['Privately messaging users', 'Creating fake accounts (""bots"")', 'Secretly changing the content of what users see']","['Political elections (e.g. voting behavior)', 'Presidential approval ratings', 'Health topics (e.g. spread of diseases)', 'Well-being and economic satisfaction', 'Public sentiment (e.g. environment-related concerns)', 'News consumption (e.g. sharing of misinformation)', 'Social networks']",3,1,7,Making sure what their doing is ethical and not harming anyone or anything.,Somewhat acceptable,,how they treated the people in their messages,Somewhat acceptable,they weren't really harming anything or going against any rules i guess,if they used deceiving or untruthful tactics or anything of that nature,Somewhat unacceptable,,,Neutral,,,Extremely important,Moderately important,Moderately important,Moderately important,Very important,Extremely important,Very important,Very important,Extremely important,None,6.0,5.0,4.0,2.0,3.0,7.0,1.0,,,,,,
26,True,569.0,Facebook,31.0,Male,White / Caucasian,Master's degree or above,Slightly conservative,Extremely aware,"['… are large and can contain millions of data points', '… reflect events in real-time and can be collected continuously over time', '… are naturalistic in that they do not require researchers to directly interact with research volunteers', '… often capture social relationships not found using traditional methods (e.g. surveys)', '… are readily accessible to researchers and easy to collect']","[""Publicly posting on users' profiles"", 'Creating fake accounts (""bots"")', 'Secretly changing the content of what users see']","['Economic forecasting', 'Health topics (e.g. spread of diseases)', 'Well-being and economic satisfaction', 'Communication (e.g. spread of opinions and hate-speech)', 'Public sentiment (e.g. environment-related concerns)', 'News consumption (e.g. sharing of misinformation)', 'Social networks']",3,1,7,"the institutional review board must determine the experiment does not provide harm to the participant. If it doesn't, then it gets ethical approval.",Somewhat acceptable,the participants should have been informed they were subject to a study,,Somewhat unacceptable,the fact that participants were not aware they were part of the research study,,Completely acceptable,,,Somewhat unacceptable,participants were never informed they participated in a study,whether users were followed up after the study informing them they were participants,Extremely important,Not at all important,Slightly important,Moderately important,Moderately important,Very important,Extremely important,Very important,Moderately important,,7.0,3.0,6.0,4.0,1.0,5.0,2.0,,,,,,
27,True,977.0,Facebook,63.0,Female,White / Caucasian,Bachelor's degree,Slightly conservative,Not at all aware,"['… are large and can contain millions of data points', '… reflect events in real-time and can be collected continuously over time', '… are naturalistic in that they do not require researchers to directly interact with research volunteers', '… often capture social relationships not found using traditional methods (e.g. surveys)', '… are readily accessible to researchers and easy to collect']","['Privately messaging users', ""Publicly posting on users' profiles"", 'Creating fake accounts (""bots"")']","['Presidential approval ratings', 'Well-being and economic satisfaction', 'Communication (e.g. spread of opinions and hate-speech)', 'Public sentiment (e.g. environment-related concerns)', 'News consumption (e.g. sharing of misinformation)', 'Social networks']",3,3,6,Ethical approval means the institution must approve of the way the research is run.  It should no cross moral or ethical boundaries.,Somewhat acceptable,"they should have been informed, but i don't see that any harm was done by not informing them",,Somewhat acceptable,"while users should be told they are in a study, i don't thing any harm occurred from not being told",,Completely acceptable,,,Somewhat unacceptable,"i don't like the creation of ""bot"" accounts  the people were not told they were in the study, which is borderline unacceptable",it sounds as if the bot responded even if the post was true  posts should have been verified as false before sending a message,Moderately important,Not at all important,Moderately important,Moderately important,Extremely important,Very important,Slightly important,Not at all important,Slightly important,,6.0,4.0,7.0,3.0,1.0,5.0,2.0,,1.0,,2.0,,3.0
28,True,2026.0,Facebook,19.0,Female,White / Caucasian,Highschool,Very liberal,Not at all aware,"['… are large and can contain millions of data points', '… reflect events in real-time and can be collected continuously over time', '… are naturalistic in that they do not require researchers to directly interact with research volunteers', '… often capture social relationships not found using traditional methods (e.g. surveys)', '… are readily accessible to researchers and easy to collect']","[""Publicly posting on users' profiles"", 'Creating fake accounts (""bots"")']","['Political elections (e.g. voting behavior)', 'Presidential approval ratings', 'News consumption (e.g. sharing of misinformation)', 'Social networks']",3,2,4,Ethical approval sounds like their research won't have any negative implications on the people being studied.,Neutral,"replying directly to someone that frequently uses hate speech just seems a little worrisome, that's all",how they went about replying to hate speech,Somewhat unacceptable,"only targeting one political party, not letting participants know of study","the headline they sent to participants, and whether it was truly non-political or if that is a matter of bias",Completely acceptable,,glad to hear the participants know about the research they will be a part of & be rewarded for their time,Somewhat unacceptable,there's nothing inherently wrong with this besides the fact that the participants don't know they're participating,,Slightly important,Very important,Moderately important,Moderately important,Slightly important,Moderately important,Extremely important,Very important,Moderately important,,7.0,6.0,5.0,3.0,1.0,4.0,2.0,,,,,,
29,True,837.0,Facebook,36.0,Female,White / Caucasian,Master's degree or above,Slightly liberal,Slightly aware,"['… are large and can contain millions of data points', '… reflect events in real-time and can be collected continuously over time', '… are naturalistic in that they do not require researchers to directly interact with research volunteers', '… are readily accessible to researchers and easy to collect']",['None of the above'],"['Political elections (e.g. voting behavior)', 'Economic forecasting', 'Presidential approval ratings']",2,0,3,It means that the actions of the researcher should not be harmful in any way to anybody. ,Somewhat unacceptable,i do not like the idea of any interaction with people who produce hate speech,,Somewhat acceptable,,,Somewhat acceptable,,,Completely unacceptable,,,Moderately important,Not at all important,Extremely important,Not at all important,Slightly important,Very important,Moderately important,Extremely important,Moderately important,,7.0,3.0,5.0,4.0,1.0,6.0,2.0,,1.0,,1.0,,1.0
30,True,523.0,Reddit,45.0,Male,White / Caucasian,Bachelor's degree,Slightly conservative,Moderately aware,"['… are large and can contain millions of data points', '… reflect events in real-time and can be collected continuously over time', '… are naturalistic in that they do not require researchers to directly interact with research volunteers', '… often capture social relationships not found using traditional methods (e.g. surveys)']","[""Publicly posting on users' profiles"", 'Creating fake accounts (""bots"")']","['Political elections (e.g. voting behavior)', 'Economic forecasting', 'Presidential approval ratings', 'Health topics (e.g. spread of diseases)', 'Well-being and economic satisfaction', 'Communication (e.g. spread of opinions and hate-speech)', 'Public sentiment (e.g. environment-related concerns)', 'News consumption (e.g. sharing of misinformation)', 'Social networks']",4,2,9,Approval from an ethics committee at the university that decides what is ethical for them to do. ,Somewhat acceptable,,,Somewhat acceptable,,,Completely acceptable,,,Somewhat acceptable,,,Very important,Slightly important,Very important,Slightly important,Moderately important,Very important,Moderately important,Moderately important,Very important,,7.0,4.0,5.0,1.0,3.0,6.0,2.0,,,,,,
31,True,783.0,Reddit,70.0,Female,White / Caucasian,Bachelor's degree,Slightly conservative,Not at all aware,"['… are large and can contain millions of data points', '… are naturalistic in that they do not require researchers to directly interact with research volunteers', '… often capture social relationships not found using traditional methods (e.g. surveys)', '… are readily accessible to researchers and easy to collect']",['None of the above'],"['Political elections (e.g. voting behavior)', 'Presidential approval ratings', 'Health topics (e.g. spread of diseases)', 'Well-being and economic satisfaction', 'Communication (e.g. spread of opinions and hate-speech)', 'Public sentiment (e.g. environment-related concerns)', 'News consumption (e.g. sharing of misinformation)']",2,0,7,"It means that the reasearcher(s) us the same standards that they would use 
for a real study.",Neutral,,,Neutral,,,Somewhat acceptable,,,Somewhat unacceptable,,,Very important,Extremely important,Moderately important,Very important,Moderately important,Moderately important,Moderately important,Moderately important,Moderately important,,3.0,4.0,6.0,7.0,2.0,5.0,1.0,,,,,,
32,True,782.0,Facebook,40.0,Female,White / Caucasian,Bachelor's degree,Slightly liberal,Slightly aware,"['… are large and can contain millions of data points', '… reflect events in real-time and can be collected continuously over time', '… are naturalistic in that they do not require researchers to directly interact with research volunteers', '… often capture social relationships not found using traditional methods (e.g. surveys)', '… are readily accessible to researchers and easy to collect']","['Privately messaging users', ""Publicly posting on users' profiles"", 'Creating fake accounts (""bots"")']","['Political elections (e.g. voting behavior)', 'Presidential approval ratings', 'Health topics (e.g. spread of diseases)', 'Well-being and economic satisfaction', 'Communication (e.g. spread of opinions and hate-speech)', 'Public sentiment (e.g. environment-related concerns)', 'News consumption (e.g. sharing of misinformation)', 'Social networks']",3,3,8,A review board must approve of the approach to collecting the data so that researches don't steal info from social media users without consent.  The researchers would also not be allowed to spread misinformation.,Somewhat unacceptable,i just think the participants should be made aware of their participation in the study so they can consent to their data being used,,Somewhat unacceptable,i don't think keeping the twitter users in the dark about their participation in the study is ethical,,Completely acceptable,,,Somewhat unacceptable,i think the participants should be made aware of their participation in the study so they can consent to their data being used,,Not at all important,Slightly important,Slightly important,Not at all important,Moderately important,Moderately important,Extremely important,Slightly important,Slightly important,,6.0,3.0,5.0,4.0,1.0,7.0,2.0,,,,,,
33,True,892.0,Facebook,35.0,Male,White / Caucasian,Bachelor's degree,Very liberal,Slightly aware,"['… are large and can contain millions of data points', '… reflect events in real-time and can be collected continuously over time', '… are naturalistic in that they do not require researchers to directly interact with research volunteers', '… often capture social relationships not found using traditional methods (e.g. surveys)', '… are readily accessible to researchers and easy to collect']",['None of the above'],"['Political elections (e.g. voting behavior)', 'Economic forecasting', 'Presidential approval ratings', 'Health topics (e.g. spread of diseases)', 'Well-being and economic satisfaction', 'Communication (e.g. spread of opinions and hate-speech)', 'Public sentiment (e.g. environment-related concerns)', 'News consumption (e.g. sharing of misinformation)', 'Social networks']",3,0,9,It means that some other body holds the researchers accountable for their actions and makes sure that what and how they are researching is above board.,Completely unacceptable,"the first red flag is not telling the other people that they are actually in any study at all and then using their data, maybe not anonymized, in the study","i would like everyone to be aware, pretty much",Somewhat acceptable,"i'm still not thrilled about the idea of having the people be unaware, but this time around you are sending them a private message, in which others cannot see, and letting them choose whether or not to open the message",maybe they could fill in the participant after the study is over on what their real intentions were,Completely acceptable,"i liked the fact that people knew about their participation and were even paid, if they so chose to go along with the study  i had no concerns about this",,Completely acceptable,"i did like how this was out in the open, basically allowing a fact-check to be in place, and then seeing how the people would react",,Moderately important,Slightly important,Moderately important,Slightly important,Moderately important,Very important,Extremely important,Slightly important,Moderately important,,6.0,3.0,5.0,2.0,1.0,7.0,4.0,,,,,,
34,True,818.0,Facebook,37.0,Female,White / Caucasian,Bachelor's degree,Very liberal,Very aware,"['… are large and can contain millions of data points', '… reflect events in real-time and can be collected continuously over time', '… often capture social relationships not found using traditional methods (e.g. surveys)']","['Creating fake accounts (""bots"")']","['Political elections (e.g. voting behavior)', 'Economic forecasting', 'Presidential approval ratings', 'Health topics (e.g. spread of diseases)', 'Well-being and economic satisfaction', 'Communication (e.g. spread of opinions and hate-speech)', 'Public sentiment (e.g. environment-related concerns)', 'News consumption (e.g. sharing of misinformation)', 'Social networks']",3,1,9,they need to run their experiment in a way that does no irreversible harm or change to the participant,Completely acceptable,,if they continued to insert themselves,Completely acceptable,,if they involved themselves more,Somewhat unacceptable,"not big on the idea of installing spy extensions on a person's browser, but understand it's voluntary to the user",,Somewhat acceptable,,i think having people involved would be better,Very important,Extremely important,Moderately important,Extremely important,Moderately important,Extremely important,Very important,Extremely important,Very important,,6.0,4.0,5.0,2.0,1.0,7.0,3.0,,,,,,
35,True,1358.0,Facebook,54.0,Female,White / Caucasian,Master's degree or above,Slightly liberal,Very aware,"['… are large and can contain millions of data points', '… reflect events in real-time and can be collected continuously over time', '… are naturalistic in that they do not require researchers to directly interact with research volunteers', '… often capture social relationships not found using traditional methods (e.g. surveys)', '… are readily accessible to researchers and easy to collect']","['Privately messaging users', ""Publicly posting on users' profiles"", 'Creating fake accounts (""bots"")', 'Secretly changing the content of what users see']","['Political elections (e.g. voting behavior)', 'Economic forecasting', 'Presidential approval ratings', 'Health topics (e.g. spread of diseases)', 'Well-being and economic satisfaction', 'Communication (e.g. spread of opinions and hate-speech)', 'Public sentiment (e.g. environment-related concerns)', 'News consumption (e.g. sharing of misinformation)', 'Social networks']",3,2,9,Ethical approval means that an outside party has evaluated the research and determined that it will not harm other people.,Completely acceptable,,,Somewhat unacceptable,no consent; needed to inform the users,,Completely acceptable,,,Somewhat acceptable,,,Slightly important,Not at all important,Very important,Not at all important,Not at all important,Extremely important,Extremely important,Moderately important,Slightly important,,7.0,1.0,6.0,4.0,2.0,5.0,3.0,,,,,,
36,True,385.0,Facebook,47.0,Male,White / Caucasian,Bachelor's degree,Neutral/ Neither conservative or liberal,Not at all aware,['… often capture social relationships not found using traditional methods (e.g. surveys)'],['None of the above'],"['Health topics (e.g. spread of diseases)', 'Public sentiment (e.g. environment-related concerns)']",1,0,2,That the researcher is demonstrating that they have adhered to the accepted ethical standards of a genuine research study.,Neutral,,,Neutral,,,Neutral,,,Neutral,,,Moderately important,Slightly important,Very important,Moderately important,Very important,Moderately important,Very important,Very important,Moderately important,,6.0,5.0,3.0,2.0,1.0,4.0,7.0,,,,,,
37,True,1087.0,Twitter,42.0,Male,White / Caucasian,Bachelor's degree,Very liberal,Very aware,"['… are large and can contain millions of data points', '… reflect events in real-time and can be collected continuously over time', '… are naturalistic in that they do not require researchers to directly interact with research volunteers', '… often capture social relationships not found using traditional methods (e.g. surveys)', '… are readily accessible to researchers and easy to collect']",['None of the above'],"['Political elections (e.g. voting behavior)', 'Economic forecasting', 'Presidential approval ratings', 'Health topics (e.g. spread of diseases)', 'Well-being and economic satisfaction', 'Communication (e.g. spread of opinions and hate-speech)', 'Public sentiment (e.g. environment-related concerns)', 'News consumption (e.g. sharing of misinformation)', 'Social networks']",3,0,9,The study is reviewed by a board at their institution to ensure the study isn't going to negatively impact any of the subjects.,Completely acceptable,,,Completely acceptable,,"i guess i would rather not receive an unsolicited dm, but this doesn't sound too obnoxious",Completely acceptable,,since they were aware they were taking part in a study it all seems above board i would generally prefer not to have to install anything,Completely acceptable,,,Not at all important,Not at all important,Moderately important,Not at all important,Not at all important,Very important,Not at all important,Moderately important,Not at all important,not really as long as researchers are using public data i'm not all that concerned,4.0,5.0,7.0,6.0,1.0,3.0,2.0,don't intentionally mislead unknowing participants sending them links to a fake fact checking site would be an example 4,,,,,
38,True,669.0,Reddit,31.0,Male,Hispanic,Highschool,Very liberal,Slightly aware,"['… reflect events in real-time and can be collected continuously over time', '… are naturalistic in that they do not require researchers to directly interact with research volunteers', '… often capture social relationships not found using traditional methods (e.g. surveys)', '… are readily accessible to researchers and easy to collect']","['Privately messaging users', 'Creating fake accounts (""bots"")']","['Political elections (e.g. voting behavior)', 'Economic forecasting', 'Presidential approval ratings', 'Health topics (e.g. spread of diseases)', 'Well-being and economic satisfaction', 'Communication (e.g. spread of opinions and hate-speech)', 'Public sentiment (e.g. environment-related concerns)', 'News consumption (e.g. sharing of misinformation)', 'Social networks']",2,2,9,Make sure they aren't harassing their subjects.,Completely acceptable,sounds like an interesting experiment i have no problems since no harm was done,if the non-empathetic messages to subjects contained bigoted remarks,Completely acceptable,i have no concerns since the participants weren't harmed,if the researchers stole private information of the subjects,Completely acceptable,it seems fine since the participants agreed to it,,Completely acceptable,seems fine it's interesting that the public reply caused users to double down,if the fact checking sites were wrong,Slightly important,Not at all important,Extremely important,Not at all important,Not at all important,Not at all important,Slightly important,Not at all important,Not at all important,,5.0,7.0,3.0,2.0,1.0,4.0,6.0,,,,,,
39,True,1259.0,Reddit,54.0,Female,White / Caucasian,Prefer not to say,Slightly conservative,Not at all aware,"['… are large and can contain millions of data points', '… reflect events in real-time and can be collected continuously over time', '… are naturalistic in that they do not require researchers to directly interact with research volunteers', '… often capture social relationships not found using traditional methods (e.g. surveys)', '… are readily accessible to researchers and easy to collect']","['Privately messaging users', 'Creating fake accounts (""bots"")']","['Political elections (e.g. voting behavior)', 'Economic forecasting', 'Presidential approval ratings', 'Health topics (e.g. spread of diseases)', 'Public sentiment (e.g. environment-related concerns)', 'News consumption (e.g. sharing of misinformation)', 'Social networks']",3,2,7,"I think it means they have to get permission after proving that their research doesn't violate any laws, moral standards, or privacy issues.",Somewhat acceptable,this one sounds legitimate and helpful,it sounds like they went about this one in a more ethical manner than the other two and it had a positive impact,Somewhat unacceptable,"i don't think ""fact checkers"" are always trustworthy",,Completely acceptable,it sounds like it was transparent and the participants were fully aware of what they were getting into,,Completely unacceptable,i don't think bots should be used without people's knowledge,,Moderately important,Very important,Very important,Moderately important,Very important,Very important,Extremely important,Moderately important,Slightly important,if the researchers have a political agenda or are unbiased,5.0,4.0,7.0,2.0,1.0,6.0,3.0,no political or social bias should be allowed,4.0,,,,
40,True,469.0,Facebook,28.0,Female,African-American,Associate's degree,Neutral/ Neither conservative or liberal,Slightly aware,"['… are large and can contain millions of data points', '… reflect events in real-time and can be collected continuously over time', '… often capture social relationships not found using traditional methods (e.g. surveys)', '… are readily accessible to researchers and easy to collect', '… are well formatted and never contain any missing data']","['Privately messaging users', ""Publicly posting on users' profiles"", 'Creating fake accounts (""bots"")', 'Secretly changing the content of what users see', ""Hacking into users' accounts""]","['Political elections (e.g. voting behavior)', 'Economic forecasting', 'Presidential approval ratings', 'Health topics (e.g. spread of diseases)', 'Well-being and economic satisfaction', 'Communication (e.g. spread of opinions and hate-speech)', 'Public sentiment (e.g. environment-related concerns)', 'News consumption (e.g. sharing of misinformation)', 'Social networks']",1,1,9,I think it means to give people the right to know who has access to their data and information,Completely unacceptable,"i feel like the more the hate topic is brought up in any way shape or form, the more negative energy is brought into the mix and that topic should just be avoided",,Neutral,,,Neutral,,,Somewhat unacceptable,,,Very important,Very important,Very important,Very important,Very important,Moderately important,Very important,Moderately important,Very important,not that i know of at the moment,6.0,2.0,7.0,3.0,1.0,5.0,4.0,,0.0,,0.0,,0.0
41,True,716.0,Twitter,34.0,Male,White / Caucasian,Some college,Neutral/ Neither conservative or liberal,Moderately aware,['… often capture social relationships not found using traditional methods (e.g. surveys)'],['None of the above'],"['Economic forecasting', 'Well-being and economic satisfaction', 'Public sentiment (e.g. environment-related concerns)']",1,0,3,"Well, I'm sure there is someone out there that can define it better but I believe not doing any physical or mental harm.",Neutral,,,Somewhat unacceptable,i find all this ridiculous but i guess to get result eh,,Neutral,cheap takes more then a cheeseburger and a drink to spy on my account for a week xd,"dude, 5$ you almost pay 5$ to walk into the wal mart now xd",Completely unacceptable,None,,Extremely important,Extremely important,Extremely important,Moderately important,Not at all important,Moderately important,Extremely important,Moderately important,Extremely important,i don't even i mainly get on twitter for gaming information do gamer studies,7.0,4.0,6.0,3.0,1.0,5.0,2.0,,,,,,
42,True,539.0,Twitter,59.0,Female,White / Caucasian,Bachelor's degree,Slightly conservative,Not at all aware,"['… are large and can contain millions of data points', '… often capture social relationships not found using traditional methods (e.g. surveys)', '… are always representative of people’s offline behavior']","['Creating fake accounts (""bots"")']","['Political elections (e.g. voting behavior)', 'Presidential approval ratings', 'Health topics (e.g. spread of diseases)', 'Communication (e.g. spread of opinions and hate-speech)', 'Public sentiment (e.g. environment-related concerns)', 'News consumption (e.g. sharing of misinformation)']",1,1,6,Ethical approval to me is the process that the researchers will be ethical and honest when conducting their research.,Completely acceptable,,i think it is making a difference if the hate speech was lessened or removed,Completely acceptable,,,Completely acceptable,when there is an incentive it may make data less useable people may not give their true opinions of fear of not getting the incentive,,Completely acceptable,i think it is great if it reduces the tweets or retweets,,Very important,Very important,Extremely important,Very important,Slightly important,Not at all important,Not at all important,Extremely important,Very important,,7.0,3.0,6.0,2.0,4.0,5.0,1.0,,,,,,
43,True,918.0,Twitter,52.0,Male,White / Caucasian,Bachelor's degree,Neutral/ Neither conservative or liberal,Very aware,"['… are large and can contain millions of data points', '… are readily accessible to researchers and easy to collect']","['Creating fake accounts (""bots"")']","['Political elections (e.g. voting behavior)', 'Health topics (e.g. spread of diseases)', 'Communication (e.g. spread of opinions and hate-speech)', 'News consumption (e.g. sharing of misinformation)']",0,1,4,It's about how participants are treated. It's much worse on social media in my opinion and I don't think these should get irb approval. ,Neutral,"again, you are purposely manipulating people for the purpose of research i don't know that that is ethical on its face, also the fact they are not aware they are taking part in research i understand that there may be a taint to it if you let them know ahead of time so i don't know whether this is unacceptable or not",,Somewhat acceptable,it's manipulation and not disclosing the purpose,,Somewhat unacceptable,lotteries for payment really suck gift cards aren't that great either,,Completely unacceptable,"i don't think automated accounts should be created to interact with people for the purpose of research you are manipulating people without their consent, although i suppose that's something that should be known to anyone using social media generally",,Very important,Not at all important,Moderately important,Not at all important,Extremely important,Very important,Slightly important,Extremely important,Moderately important,"well i certainly learned something here i had no idea you all were carrying out experiments in this manner i see the more obvious ones advertised but have not been aware of the stealth ones that does concern me, especially given that what people post publicly isn't necessarily all that they post",6.0,7.0,1.0,2.0,5.0,4.0,3.0,,,,,,
44,True,659.0,Facebook,38.0,Female,White / Caucasian,Bachelor's degree,Neutral/ Neither conservative or liberal,Slightly aware,"['… are large and can contain millions of data points', '… reflect events in real-time and can be collected continuously over time', '… are naturalistic in that they do not require researchers to directly interact with research volunteers', '… often capture social relationships not found using traditional methods (e.g. surveys)', '… are readily accessible to researchers and easy to collect']","['Privately messaging users', ""Publicly posting on users' profiles"", 'Creating fake accounts (""bots"")']","['Political elections (e.g. voting behavior)', 'Well-being and economic satisfaction', 'Communication (e.g. spread of opinions and hate-speech)', 'News consumption (e.g. sharing of misinformation)', 'Social networks']",3,3,5,Ethical approval means transparency in research and showing that the researcher is able to conduct their study in an ethical manner.,Completely acceptable,,,Completely acceptable,,,Neutral,"the only concern is that they the participants were seemingly bribed to ""like"" pages they otherwise would not, which may create some sort of positive bias toward the news outlet by obtaining more likes",,Completely acceptable,,,Moderately important,Extremely important,Not at all important,Extremely important,Moderately important,Extremely important,Moderately important,Extremely important,Moderately important,i believe it depends on the type of research conducted as to whether or not participant awareness of study is ethically important,7.0,3.0,5.0,6.0,1.0,2.0,4.0,,8.0,,9.0,,10.0
45,True,1938.0,Facebook,45.0,Male,White / Caucasian,Master's degree or above,Slightly conservative,Very aware,"['… are large and can contain millions of data points', '… reflect events in real-time and can be collected continuously over time', '… are readily accessible to researchers and easy to collect']","['Privately messaging users', ""Publicly posting on users' profiles""]","['Political elections (e.g. voting behavior)', 'Economic forecasting', 'Health topics (e.g. spread of diseases)', 'Well-being and economic satisfaction', 'Communication (e.g. spread of opinions and hate-speech)', 'Public sentiment (e.g. environment-related concerns)']",1,2,6,It would mean approving something that is ethical in terms.  The person making the approval would look at the value of each situation and determine if it was morally acceptable.,Somewhat unacceptable,,,Somewhat acceptable,,,Somewhat acceptable,,,Neutral,,,Very important,Slightly important,Moderately important,Very important,Moderately important,Very important,Extremely important,Very important,Very important,,7.0,2.0,5.0,4.0,1.0,6.0,3.0,,,,,,
46,True,1726.0,Reddit,36.0,Female,African-American,Associate's degree,Slightly liberal,Moderately aware,"['… are large and can contain millions of data points', '… reflect events in real-time and can be collected continuously over time', '… are naturalistic in that they do not require researchers to directly interact with research volunteers', '… often capture social relationships not found using traditional methods (e.g. surveys)', '… are readily accessible to researchers and easy to collect']",['Privately messaging users'],"['Health topics (e.g. spread of diseases)', 'Communication (e.g. spread of opinions and hate-speech)', 'Public sentiment (e.g. environment-related concerns)', 'News consumption (e.g. sharing of misinformation)', 'Social networks']",3,1,5,To me that means that the research that they want to do has to meet a certain standard that is agreed upon to be fair to those who participate. Also that they are doing this research with genuine intent to learn and understand the information they are studying.,Completely acceptable,,,Neutral,i would think that sending them a non-political headline to judge wouldn't be effective in seeing if they could be fair when it comes to sharing information that supports their side,i would have wanted them to send a left learning headline that was accurate and proved a point they supported with wrong to see if the people they were studying would be fair or just dismiss it as misinformation just because it went against something they believe to be true,Somewhat acceptable,,,Somewhat acceptable,,i would like to have known what websites were used to fact check the information and the subject of the tweets they were replying to,Moderately important,Very important,Extremely important,Very important,Slightly important,Moderately important,Moderately important,Not at all important,Very important,just making sure that the researcher doesn't let their own biases influence the data they are trying to collect and that they are honest when it comes to their methods and results,7.0,4.0,3.0,1.0,2.0,6.0,5.0,,,,,,
47,True,508.0,Twitter,37.0,Male,White / Caucasian,Bachelor's degree,Neutral/ Neither conservative or liberal,Very aware,"['… are large and can contain millions of data points', '… reflect events in real-time and can be collected continuously over time']","['Creating fake accounts (""bots"")']","['Political elections (e.g. voting behavior)', 'Economic forecasting', 'Health topics (e.g. spread of diseases)', 'Public sentiment (e.g. environment-related concerns)', 'News consumption (e.g. sharing of misinformation)']",2,1,5,The approval from a governing body that oversees what takes place under the umbrella they control.,Somewhat acceptable,,,Neutral,,,Neutral,,,Somewhat unacceptable,,"where are the facts from, and what happens when those are dis-proven?",Slightly important,Not at all important,Extremely important,Slightly important,Moderately important,Extremely important,Extremely important,Moderately important,Slightly important,"what type of vetting process is in play to avoid the same fake accounts used to trick people also being classified as a ""real"" person and thus a viable target for experimentation?",6.0,1.0,3.0,2.0,4.0,5.0,7.0,,1.0,,1.0,,1.0
48,True,459.0,Reddit,49.0,Male,White / Caucasian,Bachelor's degree,Slightly liberal,Moderately aware,"['… are large and can contain millions of data points', '… are naturalistic in that they do not require researchers to directly interact with research volunteers', '… often capture social relationships not found using traditional methods (e.g. surveys)', '… are readily accessible to researchers and easy to collect']","['Privately messaging users', ""Publicly posting on users' profiles"", 'Creating fake accounts (""bots"")', 'Secretly changing the content of what users see']","['Political elections (e.g. voting behavior)', 'Economic forecasting', 'Presidential approval ratings', 'Health topics (e.g. spread of diseases)', 'Well-being and economic satisfaction', 'Communication (e.g. spread of opinions and hate-speech)', 'Public sentiment (e.g. environment-related concerns)', 'News consumption (e.g. sharing of misinformation)', 'Social networks']",2,2,9,Peer reviewed methodology to ensure that their experiments will not cause harm.,Somewhat acceptable,,,Somewhat acceptable,,,Somewhat acceptable,,,Somewhat unacceptable,,,Moderately important,Moderately important,Moderately important,Moderately important,Slightly important,Moderately important,Moderately important,Very important,Moderately important,,3.0,6.0,4.0,2.0,1.0,5.0,7.0,,,,,,
49,True,1300.0,Facebook,50.0,Female,White / Caucasian,Master's degree or above,Slightly conservative,Slightly aware,"['… reflect events in real-time and can be collected continuously over time', '… are naturalistic in that they do not require researchers to directly interact with research volunteers', '… are readily accessible to researchers and easy to collect']","['Privately messaging users', 'Creating fake accounts (""bots"")']","['Health topics (e.g. spread of diseases)', 'Well-being and economic satisfaction', 'Communication (e.g. spread of opinions and hate-speech)', 'Public sentiment (e.g. environment-related concerns)', 'News consumption (e.g. sharing of misinformation)']",1,2,5,Ethical approval probably means that a committee looks at the questions that are being asked and makes sure that they are morally acceptable,Somewhat acceptable,is there a moral issue with not notifying someone that they are part of a study?  would they have acted differently if they had known?,,Somewhat unacceptable,"seems like the same study should have also been carried out with ""left leaning"" twitter users","seems like the same study should have also been carried out with ""left leaning"" twitter users",Somewhat acceptable,did the offer of money change the participant pool?  were people more or less likely to participate when money is on the table?,,Neutral,,,Moderately important,Very important,Moderately important,Very important,Slightly important,Very important,Very important,Moderately important,Moderately important,,3.0,6.0,7.0,4.0,2.0,5.0,1.0,,,,,,
50,True,1384.0,Facebook,44.0,Female,White / Caucasian,Highschool,Slightly conservative,Slightly aware,"['… are large and can contain millions of data points', '… reflect events in real-time and can be collected continuously over time', '… often capture social relationships not found using traditional methods (e.g. surveys)', '… are readily accessible to researchers and easy to collect']",['Privately messaging users'],"['Political elections (e.g. voting behavior)', 'Presidential approval ratings', 'Well-being and economic satisfaction', 'Communication (e.g. spread of opinions and hate-speech)', 'Public sentiment (e.g. environment-related concerns)', 'News consumption (e.g. sharing of misinformation)', 'Social networks']",2,1,7,If the research stands up to standards of the  institution.  Does not violate anyones rights.,Somewhat acceptable,all they did was post a reply and waited i do not see an issue with this,what was the reply they posted what is the researchers definition of a empathic replay  was it guilting the poster,Somewhat unacceptable,"why did they only target ""right wing""  who are the ""fact checkers""","what were the end results how many actually did send ""more accurate"" news",Completely acceptable,the researchers actively recruited these people so i have no concerns,,Neutral,i think if people see the might not be true mark they automatically stay away from it,,Very important,Slightly important,Slightly important,Very important,Very important,Very important,Slightly important,Very important,Very important,the only thing i saw is the research targeted right leaning and did not go after left leaning  you have to do both,1.0,6.0,7.0,2.0,4.0,3.0,5.0,,,,,,
51,True,441.0,Reddit,44.0,Female,White / Caucasian,Master's degree or above,Very liberal,Slightly aware,"['… are large and can contain millions of data points', '… reflect events in real-time and can be collected continuously over time', '… often capture social relationships not found using traditional methods (e.g. surveys)', '… are readily accessible to researchers and easy to collect']","['Creating fake accounts (""bots"")']","['Political elections (e.g. voting behavior)', 'Economic forecasting', 'Presidential approval ratings', 'Health topics (e.g. spread of diseases)', 'Well-being and economic satisfaction', 'Communication (e.g. spread of opinions and hate-speech)', 'Public sentiment (e.g. environment-related concerns)', 'Social networks']",2,1,8,That the subject of the study understands that their data will be used,Completely acceptable,,,Somewhat acceptable,,,Completely acceptable,at first i thought that paying subjects could be problematic but then i realized that they had to be incentivized to install the program on their computer,,Completely acceptable,,,Very important,Not at all important,Very important,Not at all important,Very important,Very important,Moderately important,Extremely important,Not at all important,,3.0,4.0,7.0,1.0,2.0,5.0,6.0,,,,,,
52,True,1046.0,Reddit,25.0,Female,White / Caucasian,Highschool,Slightly liberal,Moderately aware,"['… are naturalistic in that they do not require researchers to directly interact with research volunteers', '… often capture social relationships not found using traditional methods (e.g. surveys)', '… are readily accessible to researchers and easy to collect']","['Privately messaging users', 'Creating fake accounts (""bots"")', 'Secretly changing the content of what users see']","['Political elections (e.g. voting behavior)', 'Presidential approval ratings', 'Health topics (e.g. spread of diseases)', 'Communication (e.g. spread of opinions and hate-speech)', 'News consumption (e.g. sharing of misinformation)', 'Social networks']",1,1,6,"Making sure that research follows rules and guidelines to ensure that it is done in an ethical manner, to prevent harm or misinformation",Somewhat unacceptable,"again, its unethical to me that they didnt know they were in a study",,Completely unacceptable,i think it is unethical as they did not consent to be in a study,,Somewhat unacceptable,it seems very invasive of one's privacy for such little reward,,Somewhat unacceptable,"same as before, they didnt consent to be part of the research",,Very important,Slightly important,Moderately important,Moderately important,Moderately important,Very important,Extremely important,Very important,Moderately important,,6.0,2.0,7.0,4.0,1.0,5.0,3.0,,,,,,
53,True,1355.0,Facebook,66.0,Male,Asian - Eastern,Master's degree or above,Slightly liberal,Not at all aware,"['… are large and can contain millions of data points', '… reflect events in real-time and can be collected continuously over time']",['None of the above'],['Communication (e.g. spread of opinions and hate-speech)'],2,0,1,"Making sure that personal data are not manipulated, distorted, illegally obtained",Somewhat unacceptable,all participants should be informed first and the choice whether to participate or not,,Somewhat unacceptable,"any survey should always notify the participants in the first place, period",,Neutral,each participant was given a choice of engaging in the study but these people were 'targeted' in the first place so the question is what was the criterion? so the outcome may be skewed to reflect biases instead of being random,,Somewhat unacceptable,all surveys should inform each participant whether to participate or not first,,Extremely important,Extremely important,Very important,Extremely important,Extremely important,Extremely important,Extremely important,Extremely important,Extremely important,there are many 'fakers' on social media platforms,7.0,4.0,5.0,3.0,1.0,6.0,2.0,,,,,,
54,True,577.0,Facebook,30.0,Male,White / Caucasian,Bachelor's degree,Slightly conservative,Moderately aware,"['… are always representative of people’s offline behavior', '… are well formatted and never contain any missing data']",['Privately messaging users'],['Social networks'],-2,1,1,"Ethics approval is needed for any research that involves human participants; their tissue and /or data to ensure that the dignity, rights, safety and well-being of all participants are the primary consideration of the research project.",Neutral,,,Neutral,,,Neutral,,,Neutral,,,Very important,Moderately important,Very important,Moderately important,Very important,Moderately important,Moderately important,Very important,Moderately important,i didn't thing anything like that,2.0,3.0,4.0,6.0,7.0,5.0,1.0,,6.0,,7.0,,9.0
55,True,460.0,Facebook,49.0,Female,African-American,Bachelor's degree,Slightly liberal,Moderately aware,"['… are large and can contain millions of data points', '… reflect events in real-time and can be collected continuously over time', '… are naturalistic in that they do not require researchers to directly interact with research volunteers', '… often capture social relationships not found using traditional methods (e.g. surveys)', '… are readily accessible to researchers and easy to collect']","['Privately messaging users', ""Publicly posting on users' profiles""]","['Political elections (e.g. voting behavior)', 'Economic forecasting', 'Presidential approval ratings', 'Health topics (e.g. spread of diseases)', 'Well-being and economic satisfaction', 'Communication (e.g. spread of opinions and hate-speech)', 'Public sentiment (e.g. environment-related concerns)', 'News consumption (e.g. sharing of misinformation)', 'Social networks']",3,2,9,It's permission to use the info gathered from a user. ,Somewhat acceptable,,,Somewhat acceptable,,,Somewhat acceptable,,,Somewhat unacceptable,,,Moderately important,Slightly important,Moderately important,Slightly important,Slightly important,Moderately important,Slightly important,Moderately important,Moderately important,,6.0,3.0,2.0,4.0,1.0,5.0,7.0,,1.0,,1.0,,1.0
56,True,694.0,Facebook,42.0,Female,African-American,Bachelor's degree,Very liberal,Moderately aware,"['… are large and can contain millions of data points', '… reflect events in real-time and can be collected continuously over time', '… are readily accessible to researchers and easy to collect']",['Privately messaging users'],"['Political elections (e.g. voting behavior)', 'Economic forecasting', 'Health topics (e.g. spread of diseases)', 'Well-being and economic satisfaction', 'Communication (e.g. spread of opinions and hate-speech)', 'Public sentiment (e.g. environment-related concerns)', 'News consumption (e.g. sharing of misinformation)', 'Social networks']",1,1,8,There is some kind of ethics committee or board that will determine if the proposed experiment is honest and does not violate any human rights or norms.,Completely unacceptable,,,Somewhat unacceptable,,,Completely acceptable,,,Completely unacceptable,,,Very important,Very important,Very important,Very important,Very important,Very important,Extremely important,Very important,Very important,,5.0,1.0,3.0,2.0,6.0,7.0,4.0,,,,,,
57,True,904.0,Reddit,54.0,Male,White / Caucasian,Bachelor's degree,Slightly liberal,Slightly aware,"['… are large and can contain millions of data points', '… reflect events in real-time and can be collected continuously over time', '… often capture social relationships not found using traditional methods (e.g. surveys)', '… are readily accessible to researchers and easy to collect']","['Privately messaging users', 'Creating fake accounts (""bots"")']","['Political elections (e.g. voting behavior)', 'Economic forecasting', 'Presidential approval ratings', 'Health topics (e.g. spread of diseases)', 'Well-being and economic satisfaction', 'Communication (e.g. spread of opinions and hate-speech)', 'Public sentiment (e.g. environment-related concerns)', 'News consumption (e.g. sharing of misinformation)', 'Social networks']",2,2,9,A review of the proposed experiment to determine if its methods are in compliance with academic standards on ethics.,Neutral,,"i would want to know more about the nature of the replies to the subjects' posts, such as frequency, tone, etc",Somewhat unacceptable,i am concerned that subjects were actively recruited into a study for which they did not give their consent and were not given any information,,Completely acceptable,,i would want to know if subjects were made aware of the purpose of adding the extension prior to agreeing to do so,Somewhat unacceptable,"again my primary concern is that the researchers actively engaged with subjects without informing them of the purpose, and without gaining their approval",,Moderately important,Extremely important,Very important,Very important,Moderately important,Very important,Extremely important,Very important,Moderately important,,6.0,4.0,5.0,3.0,2.0,7.0,1.0,,,,,,
58,True,678.0,Facebook,35.0,Male,White / Caucasian,Highschool,Neutral/ Neither conservative or liberal,Slightly aware,"['… are large and can contain millions of data points', '… reflect events in real-time and can be collected continuously over time', '… are naturalistic in that they do not require researchers to directly interact with research volunteers', '… often capture social relationships not found using traditional methods (e.g. surveys)', '… are readily accessible to researchers and easy to collect']","['Privately messaging users', ""Publicly posting on users' profiles"", 'Creating fake accounts (""bots"")']","['Political elections (e.g. voting behavior)', 'Health topics (e.g. spread of diseases)', 'Well-being and economic satisfaction', 'Communication (e.g. spread of opinions and hate-speech)', 'Public sentiment (e.g. environment-related concerns)', 'News consumption (e.g. sharing of misinformation)']",3,3,6,"Whatever it is, it's not ethical. It's just another form of data collecting without consent.",Somewhat unacceptable,"seems they scared them, and temporary change in behavior based on given manipulated feedback",,Somewhat unacceptable,no consent to those being manipulated,,Neutral,at least they had permission and compensated these people this is the first one i can be ok with to be honest,,Somewhat unacceptable,"this outcome is predictable, they're set in their ways and don't care not getting their consent is basically spamming them without context or permissionconcern for the mental state these ""people"" may be in",,Moderately important,Very important,Extremely important,Extremely important,Not at all important,Very important,Extremely important,Moderately important,Extremely important,compensate these people and stop spying without consent you're knowingly invading their privacy and stealing information,7.0,1.0,2.0,4.0,3.0,6.0,5.0,,8.0,,9.0,,10.0
59,True,225.0,Twitter,39.0,Female,White / Caucasian,Master's degree or above,Neutral/ Neither conservative or liberal,Moderately aware,"['… are large and can contain millions of data points', '… reflect events in real-time and can be collected continuously over time', '… are naturalistic in that they do not require researchers to directly interact with research volunteers', '… often capture social relationships not found using traditional methods (e.g. surveys)', '… are readily accessible to researchers and easy to collect']","['Privately messaging users', 'Secretly changing the content of what users see']","['Political elections (e.g. voting behavior)', 'Economic forecasting', 'Presidential approval ratings', 'Health topics (e.g. spread of diseases)', 'Well-being and economic satisfaction', 'Communication (e.g. spread of opinions and hate-speech)', 'Public sentiment (e.g. environment-related concerns)', 'News consumption (e.g. sharing of misinformation)', 'Social networks']",3,0,9,That it treats human subjects fairly and transparently.,Completely acceptable,,,Completely acceptable,,,Completely acceptable,,,Somewhat unacceptable,participants should have been told,,Extremely important,Not at all important,Very important,Moderately important,Very important,Moderately important,Extremely important,Slightly important,Moderately important,,1.0,7.0,3.0,5.0,2.0,4.0,6.0,,,,,,
60,True,1242.0,Facebook,37.0,Male,African-American,Master's degree or above,Very conservative,Very aware,['… reflect events in real-time and can be collected continuously over time'],"[""Publicly posting on users' profiles""]",['Political elections (e.g. voting behavior)'],1,1,1,Ethical approval is when the researcher is showing that they have followed the accepted ethical standards of a genuine research study,Somewhat acceptable,,,Neutral,,,Somewhat acceptable,,,Neutral,,,Moderately important,Moderately important,Very important,Moderately important,Very important,Moderately important,Very important,Moderately important,Very important,,3.0,5.0,1.0,4.0,6.0,7.0,2.0,None,7.0,abiding by the laws of research,8.0,confidentiality of participants information,9.0
61,True,510.0,Facebook,56.0,Female,White / Caucasian,Bachelor's degree,Slightly conservative,Extremely aware,['None of the above'],"[""Publicly posting on users' profiles"", 'Creating fake accounts (""bots"")', 'Secretly changing the content of what users see']","['Political elections (e.g. voting behavior)', 'Health topics (e.g. spread of diseases)', 'News consumption (e.g. sharing of misinformation)', 'Social networks']",0,1,4,It means whether or not they are violating ETHICS when gathering information.,Completely unacceptable,"there is an error in your answer bubbles abovethe word ""completely"" is misspelled",,Completely unacceptable,,,Completely acceptable,there is an error in your answer bubbles above the word acceptable is misspelled,,Completely unacceptable,,,Extremely important,Extremely important,Not at all important,Moderately important,Extremely important,Extremely important,Extremely important,Not at all important,Extremely important,,6.0,2.0,7.0,3.0,5.0,4.0,1.0,,,,,,
62,True,379.0,Twitter,23.0,Male,White / Caucasian,Highschool,Neutral/ Neither conservative or liberal,Extremely aware,"['… are large and can contain millions of data points', '… reflect events in real-time and can be collected continuously over time', '… are naturalistic in that they do not require researchers to directly interact with research volunteers', '… are readily accessible to researchers and easy to collect']","['Privately messaging users', ""Publicly posting on users' profiles"", 'Creating fake accounts (""bots"")', 'Secretly changing the content of what users see']","['Political elections (e.g. voting behavior)', 'Economic forecasting', 'Presidential approval ratings', 'Health topics (e.g. spread of diseases)', 'Well-being and economic satisfaction', 'Communication (e.g. spread of opinions and hate-speech)', 'Public sentiment (e.g. environment-related concerns)', 'News consumption (e.g. sharing of misinformation)', 'Social networks']",2,2,9,make participants aware they are being recorded,Somewhat unacceptable,,,Somewhat unacceptable,"people act differently online and would also react differently knowing they are being ""studied""",,Neutral,,,Somewhat unacceptable,,,Very important,Very important,Very important,Very important,Very important,Very important,Very important,Very important,Very important,,4.0,1.0,5.0,3.0,6.0,7.0,2.0,,,,,,
63,True,1998.0,Facebook,44.0,Male,Hispanic,Highschool,Slightly liberal,Extremely aware,"['… are large and can contain millions of data points', '… reflect events in real-time and can be collected continuously over time', '… are naturalistic in that they do not require researchers to directly interact with research volunteers', '… often capture social relationships not found using traditional methods (e.g. surveys)', '… are readily accessible to researchers and easy to collect']",['Privately messaging users'],"['Political elections (e.g. voting behavior)', 'Economic forecasting', 'Presidential approval ratings', 'Health topics (e.g. spread of diseases)', 'Well-being and economic satisfaction', 'Communication (e.g. spread of opinions and hate-speech)', 'Public sentiment (e.g. environment-related concerns)', 'News consumption (e.g. sharing of misinformation)', 'Social networks']",3,1,9,probably that the institution they work for endorses the work they are doing and supports it.,Completely unacceptable,"not only did they manipulate people's opinion with bots, but they used their information without warning which is unfair",,Completely unacceptable,"i believe that using a person's information without their authorization violates their privacy and rights, that is why i think that although the investigation yielded good results, the end does not justify the means",,Somewhat acceptable,"although i believe that the researchers would have an easier time collecting information thanks to the extension, this also worries me and it is that i possibly do not know how much information or where it could be collected in 8 weeks if i am from the study website or my browser","also the risks that a long-term study could entail and how that information would be used, that is, the specific purposes",Completely unacceptable,"like the previous article, using information from several people without their consent seems unethical to me",,Slightly important,Not at all important,Moderately important,Moderately important,Extremely important,Extremely important,Extremely important,Extremely important,Very important,"the privacy and transparency with which these studies are carried out, for me, the security of my information is one of the most important aspects",7.0,1.0,5.0,3.0,2.0,6.0,4.0,,,,,,
64,True,549.0,Twitter,19.0,Female,White / Caucasian,Highschool,Very liberal,Slightly aware,"['… are large and can contain millions of data points', '… reflect events in real-time and can be collected continuously over time', '… are naturalistic in that they do not require researchers to directly interact with research volunteers', '… often capture social relationships not found using traditional methods (e.g. surveys)', '… are readily accessible to researchers and easy to collect']","['Privately messaging users', ""Publicly posting on users' profiles"", 'Creating fake accounts (""bots"")']","['Political elections (e.g. voting behavior)', 'Economic forecasting', 'Presidential approval ratings', 'Health topics (e.g. spread of diseases)', 'Well-being and economic satisfaction', 'Communication (e.g. spread of opinions and hate-speech)', 'Public sentiment (e.g. environment-related concerns)', 'News consumption (e.g. sharing of misinformation)', 'Social networks']",3,3,9,"Ethical approval means that researchers need to verify that they have taken steps to reduce potential harm to participants, and that the participants will be treated fairly.",Completely acceptable,posting a reply to a tweet as part of an experiment feels more ethically acceptable to me than privately messaging them,,Somewhat acceptable,i'm not sure how i feel about people being messaged and used in an experiment without their explicit consent -- but in this situation it seems rather harmless,,Completely acceptable,,were the participants made aware of what the web browser extension would record?,Somewhat unacceptable,"using an automated system feels worse to me, and also the study had directly negative effects by increasing division and hate",,Very important,Slightly important,Slightly important,Slightly important,Moderately important,Extremely important,Very important,Very important,Not at all important,,5.0,2.0,6.0,3.0,7.0,1.0,4.0,,,,,,
65,True,895.0,Reddit,53.0,Female,Asian - Eastern,Master's degree or above,Slightly liberal,Moderately aware,"['… are large and can contain millions of data points', '… reflect events in real-time and can be collected continuously over time', '… are naturalistic in that they do not require researchers to directly interact with research volunteers', '… often capture social relationships not found using traditional methods (e.g. surveys)']","['Creating fake accounts (""bots"")']","['Political elections (e.g. voting behavior)', 'Economic forecasting', 'Presidential approval ratings', 'Health topics (e.g. spread of diseases)', 'Well-being and economic satisfaction', 'Communication (e.g. spread of opinions and hate-speech)', 'Public sentiment (e.g. environment-related concerns)', 'News consumption (e.g. sharing of misinformation)', 'Social networks']",4,1,9,"Ethical approval is when the researcher protects both themselves and the participants. They respect the the dignity, rights and safety for both sides. ",Somewhat acceptable,"it's the same as before but this time there is definitely a positive result which i think if there is a way to do good, i support it",,Neutral,"it seems a little sketchy but the twitter users could always choose not to respond or it could be something that could have happened in real life so in that instance, i get it",,Somewhat acceptable,the participants knew what they were doing and could opt out they were also receiving compensation so i think it's fine,,Neutral,i understand the need to gather information sometimes without people knowing because it changes how they behave i think this information could be useful a little sketchy but not surprising,,Very important,Moderately important,Very important,Moderately important,Slightly important,Moderately important,Moderately important,Extremely important,Extremely important,"using social media poses its own inherent risks that you know you are engaging in you give up something to be entertained by cat videos for hours, you just may not be aware of what",5.0,2.0,6.0,1.0,3.0,4.0,7.0,,,,,,
66,True,856.0,Twitter,25.0,Male,White / Caucasian,Highschool,Neutral/ Neither conservative or liberal,Not at all aware,"['… are large and can contain millions of data points', '… reflect events in real-time and can be collected continuously over time', '… are naturalistic in that they do not require researchers to directly interact with research volunteers', '… often capture social relationships not found using traditional methods (e.g. surveys)', '… are readily accessible to researchers and easy to collect']","[""Publicly posting on users' profiles"", 'Creating fake accounts (""bots"")']","['Political elections (e.g. voting behavior)', 'Economic forecasting', 'Presidential approval ratings', 'Health topics (e.g. spread of diseases)', 'Well-being and economic satisfaction', 'Communication (e.g. spread of opinions and hate-speech)', 'Public sentiment (e.g. environment-related concerns)', 'News consumption (e.g. sharing of misinformation)', 'Social networks']",3,2,9,I think it means the research needs to get approved by higher ups as a verificaiton it isn't cruel ,Completely acceptable,,,Completely acceptable,i think the only issue would be researches cherry picking who they get data from to skew it,,Completely acceptable,,,Completely acceptable,,,Moderately important,Extremely important,Extremely important,Very important,Not at all important,Not at all important,Not at all important,Moderately important,Moderately important,,4.0,7.0,3.0,2.0,5.0,6.0,1.0,,,,,,
67,True,925.0,Facebook,36.0,Male,White / Caucasian,Highschool,Very liberal,Slightly aware,"['… reflect events in real-time and can be collected continuously over time', '… often capture social relationships not found using traditional methods (e.g. surveys)', '… are readily accessible to researchers and easy to collect']",['Privately messaging users'],"['Political elections (e.g. voting behavior)', 'Economic forecasting', 'Health topics (e.g. spread of diseases)', 'News consumption (e.g. sharing of misinformation)', 'Social networks']",1,1,5,Where its clear that the guidelines going into the research are free of bias.,Somewhat unacceptable,"it seems like its too geared at a specific group of people, and may not be free of bias",,Somewhat unacceptable,,,Completely acceptable,"they were made fully aware they are part of research, so its fair when they have an understanding of whats going on",,Somewhat acceptable,"its very in depth, but i think when people have no idea they are part of research, its a gray area",,Extremely important,Slightly important,Slightly important,Not at all important,Not at all important,Slightly important,Extremely important,Slightly important,Extremely important,,5.0,1.0,7.0,4.0,2.0,6.0,3.0,None,1.0,,,,
68,True,643.0,Reddit,28.0,Male,White / Caucasian,Master's degree or above,Very liberal,Slightly aware,"['… are large and can contain millions of data points', '… reflect events in real-time and can be collected continuously over time', '… are naturalistic in that they do not require researchers to directly interact with research volunteers', '… often capture social relationships not found using traditional methods (e.g. surveys)', '… are readily accessible to researchers and easy to collect']",['None of the above'],"['Political elections (e.g. voting behavior)', 'Presidential approval ratings', 'Health topics (e.g. spread of diseases)', 'Well-being and economic satisfaction', 'Communication (e.g. spread of opinions and hate-speech)', 'Public sentiment (e.g. environment-related concerns)', 'News consumption (e.g. sharing of misinformation)', 'Social networks']",3,0,8,"Presenting information to an institutional ethics board, researchers should evaluate and describe the risks and benefits to all involved and ensure there are no conflicts of interest or ethical dilemmas associated with doing the research.",Completely unacceptable,participants should be aware they are part of a study,,Somewhat unacceptable,"again, they should know they are part of a study",,Somewhat acceptable,,do the researchers have any stake in the news outlets social media presence?,Neutral,,,Very important,Slightly important,Very important,Slightly important,Very important,Moderately important,Very important,Very important,Moderately important,,7.0,2.0,4.0,3.0,1.0,5.0,6.0,,8.0,,9.0,,10.0
69,True,486.0,Reddit,53.0,Male,White / Caucasian,Bachelor's degree,Very liberal,Extremely aware,"['… are large and can contain millions of data points', '… reflect events in real-time and can be collected continuously over time', '… are naturalistic in that they do not require researchers to directly interact with research volunteers', '… often capture social relationships not found using traditional methods (e.g. surveys)', '… are readily accessible to researchers and easy to collect']",['None of the above'],"['Political elections (e.g. voting behavior)', 'Economic forecasting', 'Presidential approval ratings', 'Health topics (e.g. spread of diseases)', 'Well-being and economic satisfaction', 'Communication (e.g. spread of opinions and hate-speech)', 'Public sentiment (e.g. environment-related concerns)', 'News consumption (e.g. sharing of misinformation)', 'Social networks']",3,0,9,"It is a check and balance situation to ensure that the experiment will do no harm to anyone the researcher is interacting with. And, that the experiment is scientifically valid as well. ",Completely acceptable,this mimics regular interaction and crosses no boundaries i am aware of,,Completely acceptable,i don't have any i'm sure far right folks would cry censorship but there wasn't any it was an appeal to someone's better nature,,Completely acceptable,it appears and though all who entered were told exactly what the terms were so there are no ethical concerns within this context,,Completely acceptable,"the action mimicked the use of twitter, no one was harmed",,Not at all important,Extremely important,Not at all important,Not at all important,Not at all important,Not at all important,Not at all important,Not at all important,Not at all important,,4.0,6.0,2.0,3.0,1.0,7.0,5.0,,,,,,
70,True,522.0,Twitter,44.0,Female,White / Caucasian,Some college,Very conservative,Slightly aware,"['… are large and can contain millions of data points', '… reflect events in real-time and can be collected continuously over time', '… are naturalistic in that they do not require researchers to directly interact with research volunteers', '… often capture social relationships not found using traditional methods (e.g. surveys)']","['Privately messaging users', ""Publicly posting on users' profiles"", 'Creating fake accounts (""bots"")']","['Political elections (e.g. voting behavior)', 'Presidential approval ratings', 'Health topics (e.g. spread of diseases)', 'Well-being and economic satisfaction', 'Communication (e.g. spread of opinions and hate-speech)', 'Public sentiment (e.g. environment-related concerns)', 'News consumption (e.g. sharing of misinformation)', 'Social networks']",4,3,8,That the experiment they are planning to run doesn't violate the ethical standards set by the institution. ,Somewhat acceptable,,,Neutral,,,Completely acceptable,,,Somewhat acceptable,,,Very important,Not at all important,Slightly important,Not at all important,Slightly important,Extremely important,Extremely important,Not at all important,Very important,whether or not someone's privacy was violated in some way,7.0,2.0,5.0,3.0,1.0,6.0,4.0,,,,,,
71,True,150.0,Reddit,39.0,Male,White / Caucasian,Master's degree or above,Neutral/ Neither conservative or liberal,Moderately aware,"['… are large and can contain millions of data points', '… reflect events in real-time and can be collected continuously over time', '… are naturalistic in that they do not require researchers to directly interact with research volunteers', '… often capture social relationships not found using traditional methods (e.g. surveys)', '… are readily accessible to researchers and easy to collect']","['Privately messaging users', ""Publicly posting on users' profiles"", 'Creating fake accounts (""bots"")']","['Political elections (e.g. voting behavior)', 'Economic forecasting', 'Presidential approval ratings', 'Health topics (e.g. spread of diseases)', 'Well-being and economic satisfaction', 'Communication (e.g. spread of opinions and hate-speech)', 'Public sentiment (e.g. environment-related concerns)', 'News consumption (e.g. sharing of misinformation)', 'Social networks']",3,3,9,It means it will cause no harm.,Completely acceptable,,,Completely acceptable,,,Completely acceptable,,,Completely acceptable,,,Very important,Not at all important,Moderately important,Moderately important,Moderately important,Very important,Very important,Very important,Very important,,7.0,2.0,4.0,5.0,1.0,3.0,6.0,,,,,,
72,True,544.0,Facebook,28.0,Female,White / Caucasian,Master's degree or above,Very liberal,Moderately aware,"['… are large and can contain millions of data points', '… reflect events in real-time and can be collected continuously over time', '… are naturalistic in that they do not require researchers to directly interact with research volunteers', '… often capture social relationships not found using traditional methods (e.g. surveys)', '… are readily accessible to researchers and easy to collect']","['Creating fake accounts (""bots"")', 'Secretly changing the content of what users see']","['Political elections (e.g. voting behavior)', 'Economic forecasting', 'Presidential approval ratings', 'Health topics (e.g. spread of diseases)', 'Well-being and economic satisfaction', 'Communication (e.g. spread of opinions and hate-speech)', 'Public sentiment (e.g. environment-related concerns)', 'News consumption (e.g. sharing of misinformation)', 'Social networks']",3,0,9,Approval from a board that says that ethically it is appropriate to run a research study. Ethically tends to mean that the benefits outweigh the harm to the participants.,Somewhat acceptable,"the deception wasn't great, but it was almost necessary",,Somewhat acceptable,"i don't love the deception, but it was necessary plus, this seemed to have helped with the spread of false information",,Completely acceptable,,,Somewhat unacceptable,the benefits did not outweigh the harm in this study,,Slightly important,Moderately important,Moderately important,Slightly important,Very important,Moderately important,Very important,Very important,Moderately important,,7.0,2.0,3.0,6.0,4.0,1.0,5.0,,,,,,
73,True,1108.0,Facebook,39.0,Female,White / Caucasian,Highschool,Slightly conservative,Not at all aware,"['… reflect events in real-time and can be collected continuously over time', '… are naturalistic in that they do not require researchers to directly interact with research volunteers', '… often capture social relationships not found using traditional methods (e.g. surveys)', '… are readily accessible to researchers and easy to collect']","['Privately messaging users', 'Creating fake accounts (""bots"")']","['Political elections (e.g. voting behavior)', 'Economic forecasting', 'Presidential approval ratings', 'Well-being and economic satisfaction', 'Social networks']",2,2,5,Approval by a third party to make sure they agree that the researcher isn't doing anything unethical,Somewhat unacceptable,participants weren't aware they were part of a study,,Neutral,,,Completely acceptable,,the people participating were compensated,Completely unacceptable,"they tricked the people by making fake, human-looking accounts",,Slightly important,Not at all important,Slightly important,Not at all important,Not at all important,Moderately important,Extremely important,Slightly important,Moderately important,,7.0,1.0,6.0,2.0,3.0,4.0,5.0,,,,,,
74,True,629.0,Twitter,27.0,Female,White / Caucasian,Prefer not to say,Slightly conservative,Extremely aware,['… are readily accessible to researchers and easy to collect'],"['Privately messaging users', ""Publicly posting on users' profiles"", 'Creating fake accounts (""bots"")']","['Health topics (e.g. spread of diseases)', 'Communication (e.g. spread of opinions and hate-speech)', 'Public sentiment (e.g. environment-related concerns)', 'Social networks']",-1,3,4,The proposed research has to meet certain requirements to ensure that it's an ethical endeavor with minimal impact on human life.,Somewhat acceptable,it's a certain to me that the participants were unaware of their content being used,,Somewhat acceptable,my only concern is individuals not being made aware that they were used in the study,,Somewhat acceptable,i find it concerning that participants had to choose between either compensation or the ability to view the results of the survey,,Somewhat acceptable,,,Not at all important,Not at all important,Not at all important,Not at all important,Not at all important,Not at all important,Extremely important,Slightly important,Not at all important,,7.0,1.0,4.0,5.0,3.0,6.0,2.0,,,,,,
75,True,730.0,Facebook,65.0,Female,White / Caucasian,Bachelor's degree,Very liberal,Not at all aware,['… often capture social relationships not found using traditional methods (e.g. surveys)'],['None of the above'],"['Presidential approval ratings', 'Public sentiment (e.g. environment-related concerns)', 'Social networks']",1,0,3,It means that the researcher adheres to ethical practices such as informing what they are using the data for. ,Completely unacceptable,,,Neutral,,,Neutral,,,Somewhat unacceptable,,,Very important,Very important,Very important,Moderately important,Very important,Very important,Very important,Very important,Very important,,7.0,3.0,5.0,2.0,1.0,4.0,6.0,,0.0,,,,
76,True,336.0,Twitter,31.0,Male,White / Caucasian,Bachelor's degree,Very conservative,Extremely aware,"['… are large and can contain millions of data points', '… often capture social relationships not found using traditional methods (e.g. surveys)', '… are readily accessible to researchers and easy to collect']",['Privately messaging users'],"['Political elections (e.g. voting behavior)', 'Economic forecasting', 'Presidential approval ratings', 'Communication (e.g. spread of opinions and hate-speech)', 'Public sentiment (e.g. environment-related concerns)', 'News consumption (e.g. sharing of misinformation)', 'Social networks']",1,1,7,I guess it means that the researchers won't use the data collected for shady stuffs.,Completely unacceptable,,,Completely unacceptable,,,Completely unacceptable,,,Completely unacceptable,,,Extremely important,Extremely important,Extremely important,Not at all important,Extremely important,Extremely important,Extremely important,Extremely important,Extremely important,,6.0,4.0,5.0,2.0,1.0,7.0,3.0,,,,,,
77,True,584.0,Reddit,23.0,Male,White / Caucasian,Bachelor's degree,Very liberal,Extremely aware,"['… are large and can contain millions of data points', '… reflect events in real-time and can be collected continuously over time', '… are naturalistic in that they do not require researchers to directly interact with research volunteers', '… often capture social relationships not found using traditional methods (e.g. surveys)', '… are readily accessible to researchers and easy to collect']","[""Publicly posting on users' profiles"", 'Creating fake accounts (""bots"")', 'Secretly changing the content of what users see']","['Political elections (e.g. voting behavior)', 'Economic forecasting', 'Presidential approval ratings', 'Well-being and economic satisfaction', 'Communication (e.g. spread of opinions and hate-speech)', 'Public sentiment (e.g. environment-related concerns)', 'News consumption (e.g. sharing of misinformation)', 'Social networks']",3,1,8,An ethics board reviews the methods of the study or experiment and decide if it is ethical enough to receive institutional support.,Completely acceptable,i don't feel like the data would be very usable or standardized,,Somewhat acceptable,"the participants should have been made aware of the study at minimum, they could have been informed after",,Somewhat unacceptable,,were the participants aware of the purpose of the extension? as long as consent was gathered it's okay,Somewhat acceptable,it'd be more acceptable if the participants were informed and could withdraw consent,,Not at all important,Not at all important,Moderately important,Not at all important,Not at all important,Moderately important,Extremely important,Very important,Moderately important,i'm concerned with how the data is handled once the study concludes,7.0,1.0,6.0,5.0,3.0,2.0,4.0,,,,,,
78,True,701.0,Facebook,63.0,Female,White / Caucasian,Bachelor's degree,Slightly conservative,Slightly aware,['… are readily accessible to researchers and easy to collect'],['None of the above'],"['Health topics (e.g. spread of diseases)', 'Communication (e.g. spread of opinions and hate-speech)', 'Public sentiment (e.g. environment-related concerns)', 'Social networks']",-1,0,4,Ethical approval should mean they need to research the source of the information and how the information was accounted for request usage of data.,Somewhat acceptable,,,Completely unacceptable,,,Completely acceptable,,,Somewhat unacceptable,,,Moderately important,Slightly important,Moderately important,Slightly important,Moderately important,Moderately important,Very important,Moderately important,Slightly important,,4.0,1.0,7.0,2.0,3.0,6.0,5.0,,,,,,
79,True,337.0,Reddit,36.0,Female,White / Caucasian,Associate's degree,Very liberal,Slightly aware,['… are readily accessible to researchers and easy to collect'],"['Creating fake accounts (""bots"")']","['Political elections (e.g. voting behavior)', 'Presidential approval ratings', 'Public sentiment (e.g. environment-related concerns)', 'News consumption (e.g. sharing of misinformation)', 'Social networks']",-1,1,5,I’m not sure exactly ,Somewhat acceptable,,,Neutral,,,Neutral,,,Neutral,,,Slightly important,Slightly important,Slightly important,Slightly important,Moderately important,Slightly important,Moderately important,Slightly important,Slightly important,,7.0,3.0,6.0,4.0,1.0,5.0,2.0,,,,,,
80,True,639.0,Twitter,29.0,Male,Mixed race,Highschool,Slightly conservative,Slightly aware,"['… are large and can contain millions of data points', '… often capture social relationships not found using traditional methods (e.g. surveys)']","['Creating fake accounts (""bots"")']","['Political elections (e.g. voting behavior)', 'Well-being and economic satisfaction']",2,1,2,"It's to see if an experiment is alright and doesn't violate any human rights, I believe",Somewhat unacceptable,,,Somewhat acceptable,,,Neutral,,,Somewhat acceptable,,,Very important,Very important,Extremely important,Moderately important,Moderately important,Extremely important,Very important,Very important,Moderately important,,6.0,1.0,7.0,2.0,3.0,5.0,4.0,,,,,,
81,True,539.0,Reddit,47.0,Male,White / Caucasian,Master's degree or above,Slightly liberal,Very aware,"['… are large and can contain millions of data points', '… reflect events in real-time and can be collected continuously over time', '… often capture social relationships not found using traditional methods (e.g. surveys)', '… are readily accessible to researchers and easy to collect']","[""Publicly posting on users' profiles""]","['Political elections (e.g. voting behavior)', 'Economic forecasting', 'Presidential approval ratings', 'Well-being and economic satisfaction', 'Communication (e.g. spread of opinions and hate-speech)', 'Public sentiment (e.g. environment-related concerns)', 'News consumption (e.g. sharing of misinformation)', 'Social networks']",2,1,8,Whether the data is being used for a good cause,Completely acceptable,,,Completely acceptable,,,Completely acceptable,,,Somewhat acceptable,,,Slightly important,Very important,Very important,Very important,Not at all important,Slightly important,Slightly important,Extremely important,Not at all important,,2.0,7.0,6.0,4.0,5.0,3.0,1.0,,,,,,
82,True,647.0,Reddit,29.0,Male,White / Caucasian,Master's degree or above,Slightly liberal,Slightly aware,"['… are large and can contain millions of data points', '… reflect events in real-time and can be collected continuously over time', '… are naturalistic in that they do not require researchers to directly interact with research volunteers', '… often capture social relationships not found using traditional methods (e.g. surveys)', '… are readily accessible to researchers and easy to collect']","['Privately messaging users', 'Creating fake accounts (""bots"")']","['Political elections (e.g. voting behavior)', 'Economic forecasting', 'Presidential approval ratings', 'Health topics (e.g. spread of diseases)', 'Well-being and economic satisfaction', 'Communication (e.g. spread of opinions and hate-speech)', 'Public sentiment (e.g. environment-related concerns)', 'News consumption (e.g. sharing of misinformation)', 'Social networks']",3,2,9,It means that their research will not cause harm by the ways in which they conduct their study.,Somewhat acceptable,"although it is concerning that these people were not aware they were apart of a research study, knowing those people cut down on their hate speech was an overall positive effect (although i don't think research should be conducted on the sole purpose of changing behavior, but the results should)",,Somewhat unacceptable,"it concerns me that these people were not aware that they were part of a study, and that their ""participation"" changed their future actions",,Neutral,,,Somewhat acceptable,again i am concerned that people were not aware they were participating in a study,,Very important,Moderately important,Not at all important,Moderately important,Very important,Extremely important,Extremely important,Extremely important,Very important,,3.0,4.0,7.0,5.0,1.0,6.0,2.0,,,,,,
83,True,949.0,Reddit,39.0,Male,White / Caucasian,Bachelor's degree,Slightly liberal,Moderately aware,"['… are large and can contain millions of data points', '… often capture social relationships not found using traditional methods (e.g. surveys)', '… are readily accessible to researchers and easy to collect']",['None of the above'],"['Communication (e.g. spread of opinions and hate-speech)', 'Public sentiment (e.g. environment-related concerns)', 'News consumption (e.g. sharing of misinformation)', 'Social networks']",1,0,4,a process to make sure they aren't doing something wrong,Neutral,,,Neutral,,,Somewhat acceptable,,,Completely unacceptable,,,Moderately important,Very important,Moderately important,Very important,Very important,Very important,Very important,Very important,Very important,,6.0,3.0,5.0,1.0,4.0,7.0,2.0,,,,,,
84,True,1609.0,Facebook,52.0,Male,White / Caucasian,Bachelor's degree,Very liberal,Very aware,"['… are large and can contain millions of data points', '… often capture social relationships not found using traditional methods (e.g. surveys)', '… are readily accessible to researchers and easy to collect', '… are always representative of people’s offline behavior', '… are unaffected by the way social media platforms work']","['Privately messaging users', ""Publicly posting on users' profiles"", 'Creating fake accounts (""bots"")', 'Secretly changing the content of what users see']","['Political elections (e.g. voting behavior)', 'Economic forecasting', 'Presidential approval ratings', 'Health topics (e.g. spread of diseases)', 'Well-being and economic satisfaction', 'Communication (e.g. spread of opinions and hate-speech)', 'Public sentiment (e.g. environment-related concerns)', 'News consumption (e.g. sharing of misinformation)', 'Social networks']",-1,2,9,be correct with the questions and the answer to not be fake or manipulative ,Completely unacceptable,,,Completely unacceptable,,,Somewhat acceptable,,,Completely unacceptable,,,Extremely important,Extremely important,Extremely important,Extremely important,Extremely important,Extremely important,Extremely important,Extremely important,Extremely important,,1.0,2.0,7.0,5.0,4.0,3.0,6.0,,0.0,,0.0,,0.0
85,True,566.0,Facebook,34.0,Male,Native-American,Highschool,Neutral/ Neither conservative or liberal,Very aware,"['… are large and can contain millions of data points', '… reflect events in real-time and can be collected continuously over time', '… often capture social relationships not found using traditional methods (e.g. surveys)', '… are readily accessible to researchers and easy to collect']","['Privately messaging users', 'Creating fake accounts (""bots"")', 'Secretly changing the content of what users see']","['Political elections (e.g. voting behavior)', 'Economic forecasting', 'Health topics (e.g. spread of diseases)', 'Well-being and economic satisfaction', 'Communication (e.g. spread of opinions and hate-speech)', 'Public sentiment (e.g. environment-related concerns)', 'News consumption (e.g. sharing of misinformation)', 'Social networks']",2,1,8,"Ethical approval would be their institution saying that how they are running their experiment and the questions they want answered are morally correct, are not going to hurt people, etc.",Somewhat acceptable,"it's always a grey spot for me, when we use ""less honest"" methods to get our data points, that being said i understand why we must, in order to get accurate results",,Somewhat unacceptable,"i don't think it's right to dm someone using fake accounts, it's even more intrusive than using comments, etc to get a reply",what was the political slant of the researchers?,Completely acceptable,,,Somewhat acceptable,"again, i have an issue of being part of a study but not knowing about it, but again, i understand for purity of data reasons why we do so",,Extremely important,Very important,Extremely important,Extremely important,Extremely important,Very important,Very important,Very important,Extremely important,"collecting and using ""private"" user data",2.0,3.0,7.0,1.0,4.0,5.0,6.0,,,,,,
86,True,568.0,Facebook,23.0,Male,White / Caucasian,Highschool,Slightly conservative,Very aware,"['… are large and can contain millions of data points', '… reflect events in real-time and can be collected continuously over time', '… are readily accessible to researchers and easy to collect']",['None of the above'],"['Communication (e.g. spread of opinions and hate-speech)', 'News consumption (e.g. sharing of misinformation)', 'Social networks']",1,0,3,Approving that their experiments aren't gonna violate these people anyway. I.e. is it moral to do.,Somewhat acceptable,,,Neutral,,,Neutral,,,Somewhat unacceptable,,,Moderately important,Not at all important,Moderately important,Not at all important,Not at all important,Moderately important,Extremely important,Moderately important,Moderately important,,7.0,1.0,5.0,2.0,4.0,6.0,3.0,,,,,,
87,True,1410.0,Twitter,18.0,Male,White / Caucasian,Highschool,Slightly liberal,Slightly aware,"['… are large and can contain millions of data points', '… reflect events in real-time and can be collected continuously over time', '… are readily accessible to researchers and easy to collect']","[""Publicly posting on users' profiles"", 'Creating fake accounts (""bots"")']","['Health topics (e.g. spread of diseases)', 'Communication (e.g. spread of opinions and hate-speech)', 'Public sentiment (e.g. environment-related concerns)', 'News consumption (e.g. sharing of misinformation)', 'Social networks']",1,2,5,I think ethical approval means getting approval on a survey to ensure that it's safe for the participants to take.,Neutral,i'm concerned about the twitter users that aren't being told they're part of an experiment,,Neutral,"i'm concerned with this one because the twitter users weren't told that they're part of a study, like the last study i think the researchers should tell the participants that they're part of a study",,Somewhat acceptable,i'm concerned with the browser extension i don't trust that it's not going to track all of my history instead of just the news sites and facebook feeds,,Neutral,i still don't think its acceptable to not tell the twitter users that you're doing a study on that you're doing a study,,Very important,Not at all important,Slightly important,Moderately important,Slightly important,Slightly important,Extremely important,Slightly important,Moderately important,,7.0,3.0,4.0,1.0,5.0,6.0,2.0,,,,,,
88,True,495.0,Facebook,32.0,Male,White / Caucasian,Bachelor's degree,Very liberal,Very aware,"['… are large and can contain millions of data points', '… reflect events in real-time and can be collected continuously over time', '… often capture social relationships not found using traditional methods (e.g. surveys)']","['Creating fake accounts (""bots"")', 'Secretly changing the content of what users see']","['Political elections (e.g. voting behavior)', 'Presidential approval ratings', 'Communication (e.g. spread of opinions and hate-speech)', 'Public sentiment (e.g. environment-related concerns)', 'News consumption (e.g. sharing of misinformation)']",3,0,5,It means that it is accepted by other researchers as a proper way to conduct research.,Somewhat acceptable,this seems like a legitimate way to conduct a study,,Completely acceptable,"none really, the users had lots of control on participating",,Neutral,None,,Neutral,"i don't really have any concerns, seems legitimate",,Moderately important,Moderately important,Very important,Slightly important,Very important,Very important,Extremely important,Very important,Very important,,4.0,7.0,3.0,1.0,5.0,6.0,2.0,,,,,,
89,True,190.0,Facebook,26.0,Female,White / Caucasian,Bachelor's degree,Slightly liberal,Slightly aware,"['… reflect events in real-time and can be collected continuously over time', '… often capture social relationships not found using traditional methods (e.g. surveys)']",['None of the above'],"['Health topics (e.g. spread of diseases)', 'Communication (e.g. spread of opinions and hate-speech)', 'Public sentiment (e.g. environment-related concerns)', 'News consumption (e.g. sharing of misinformation)']",2,0,4,To ensure the methods of data capture are ethical,Somewhat unacceptable,,,Somewhat unacceptable,,,Somewhat acceptable,,,Neutral,,,Moderately important,Very important,Moderately important,Moderately important,Slightly important,Slightly important,Very important,Slightly important,Moderately important,,4.0,2.0,1.0,6.0,3.0,5.0,7.0,,,,,,
90,True,297.0,Twitter,27.0,Female,Asian - Indian,Bachelor's degree,Very liberal,Very aware,"['… are large and can contain millions of data points', '… reflect events in real-time and can be collected continuously over time', '… often capture social relationships not found using traditional methods (e.g. surveys)', '… are readily accessible to researchers and easy to collect']","['Privately messaging users', ""Publicly posting on users' profiles"", 'Creating fake accounts (""bots"")', 'Secretly changing the content of what users see']","['Political elections (e.g. voting behavior)', 'Economic forecasting', 'Presidential approval ratings', 'Health topics (e.g. spread of diseases)', 'Well-being and economic satisfaction', 'Communication (e.g. spread of opinions and hate-speech)', 'Public sentiment (e.g. environment-related concerns)', 'News consumption (e.g. sharing of misinformation)', 'Social networks']",2,2,9,"Ethical approval means respecting the participant and not cause emotional, mental or physical harm. It came to being after many awful research such as Tuskegee.",Completely acceptable,,,Somewhat acceptable,,,Completely acceptable,,,Completely acceptable,,,Very important,Moderately important,Moderately important,Moderately important,Moderately important,Moderately important,Extremely important,Moderately important,Moderately important,,3.0,2.0,7.0,6.0,5.0,1.0,4.0,,,,,,
91,True,932.0,Twitter,37.0,Male,White / Caucasian,Highschool,Slightly liberal,Extremely aware,"['… are large and can contain millions of data points', '… reflect events in real-time and can be collected continuously over time', '… are readily accessible to researchers and easy to collect']",['None of the above'],"['Political elections (e.g. voting behavior)', 'Presidential approval ratings', 'Health topics (e.g. spread of diseases)', 'Well-being and economic satisfaction', 'Communication (e.g. spread of opinions and hate-speech)', 'Public sentiment (e.g. environment-related concerns)']",1,0,6,They sign a paper.,Somewhat acceptable,most of you have no idea what is hate speech or trolling a big reason why conservatives act the way they do is because of liberal arrogance believing they have the facts or morals,,Somewhat unacceptable,i don't believe this happened at all,you can't stop misinformation with one comment,Somewhat acceptable,if someone decided to understand opposing political views because of an academic study they were already understanding them,,Neutral,you can't influence people's political opinions off of a few comments you also can't provide an example of a professional fact checker that actually represents truth all of you are biased,,Slightly important,Slightly important,Slightly important,Slightly important,Slightly important,Moderately important,Moderately important,Slightly important,Slightly important,i don't think researchers know what they are doing or can explain much,3.0,5.0,6.0,2.0,1.0,4.0,7.0,,,,,,
92,True,1459.0,Facebook,52.0,Female,White / Caucasian,Bachelor's degree,Slightly liberal,Slightly aware,"['… are large and can contain millions of data points', '… reflect events in real-time and can be collected continuously over time', '… are naturalistic in that they do not require researchers to directly interact with research volunteers', '… often capture social relationships not found using traditional methods (e.g. surveys)']","['Privately messaging users', ""Publicly posting on users' profiles"", 'Secretly changing the content of what users see']","['Political elections (e.g. voting behavior)', 'Economic forecasting', 'Presidential approval ratings', 'Health topics (e.g. spread of diseases)', 'Well-being and economic satisfaction', 'Communication (e.g. spread of opinions and hate-speech)', 'Public sentiment (e.g. environment-related concerns)', 'News consumption (e.g. sharing of misinformation)', 'Social networks']",4,1,9,"It means your institution believes you will handle your experiments in a legal way that will bring no harm to the participants, yourself or your institution.",Completely acceptable,interesting study that i feel is completely ethical!,"it would change my opinion if the targeted only one racial, gender,  political, or sexually oriented group",Somewhat unacceptable,i understand that specific groups sometimes need to be studied but i think it is somewhat biased in that members of all political groups have shared misinformation at one time or another independent of which political way they leaned,,Completely acceptable,i think this on is the most ethical of the studies so far,,Completely acceptable,,,Very important,Moderately important,Extremely important,Slightly important,Not at all important,Moderately important,Very important,Extremely important,Moderately important,"if a participant's private information about themselves or their family, or if pictures were gathered i would be deeply concerned",4.0,5.0,6.0,2.0,1.0,7.0,3.0,,,,,,
93,True,415.0,Twitter,25.0,Female,White / Caucasian,Bachelor's degree,Very liberal,Very aware,['… are always representative of people’s offline behavior'],"[""Publicly posting on users' profiles""]",['Social networks'],-1,1,1,Ethical approval means if a tweet is abiding by the morality rules of goodness when it comes to the type of content that the tweet is projecting.,Neutral,does this promote more hateful content on twitter?,,Somewhat acceptable,how would this affect the outcomes of this political competition?,,Completely acceptable,i think that this is a great compensation for the study,,Neutral,,,Very important,Very important,Very important,Very important,Extremely important,Very important,Moderately important,Very important,Very important,,5.0,7.0,4.0,2.0,1.0,6.0,3.0,,3.0,,1.0,,2.0
94,True,991.0,Facebook,64.0,Female,White / Caucasian,Highschool,Very conservative,Very aware,"['… are large and can contain millions of data points', '… reflect events in real-time and can be collected continuously over time', '… are naturalistic in that they do not require researchers to directly interact with research volunteers', '… often capture social relationships not found using traditional methods (e.g. surveys)', '… are readily accessible to researchers and easy to collect']","['Privately messaging users', 'Creating fake accounts (""bots"")', 'Secretly changing the content of what users see']","['Political elections (e.g. voting behavior)', 'Presidential approval ratings', 'Health topics (e.g. spread of diseases)', 'Well-being and economic satisfaction', 'Communication (e.g. spread of opinions and hate-speech)', 'Public sentiment (e.g. environment-related concerns)', 'News consumption (e.g. sharing of misinformation)', 'Social networks']",3,1,8,I'm not sure but I think it means formally asking permission to use data found online and elsewhere.,Somewhat unacceptable,hate speech is a very broad concept i don't like that the researchers tried to influence or shame posters because of perceived hate speech,,Somewhat acceptable,,fact checkers are notoriously left leaning so i would disagree with that part of the experiment,Completely acceptable,,,Somewhat acceptable,i don't like the idea of fake accounts but i guess it's acceptable now,,Very important,Not at all important,Moderately important,Not at all important,Moderately important,Very important,Very important,Moderately important,Very important,,6.0,4.0,2.0,5.0,1.0,7.0,3.0,,,,,,
95,True,1349.0,Twitter,46.0,Prefer not to say,Prefer not to say,Prefer not to say,Prefer not to say,Very aware,"['… are large and can contain millions of data points', '… reflect events in real-time and can be collected continuously over time', '… are naturalistic in that they do not require researchers to directly interact with research volunteers', '… often capture social relationships not found using traditional methods (e.g. surveys)', '… are readily accessible to researchers and easy to collect', '… are always representative of people’s offline behavior', '… are unaffected by the way social media platforms work']","['Privately messaging users', ""Publicly posting on users' profiles"", 'Creating fake accounts (""bots"")']","['Political elections (e.g. voting behavior)', 'Presidential approval ratings', 'Well-being and economic satisfaction', 'Communication (e.g. spread of opinions and hate-speech)', 'Public sentiment (e.g. environment-related concerns)', 'News consumption (e.g. sharing of misinformation)', 'Social networks']",1,3,7,"A component of the research process, whose purpose is to protect both the researcher and the participants in the research, which should have their dignity, rights, safety, and welfare respected. ",Neutral,,,Neutral,,,Somewhat acceptable,,,Neutral,,,Very important,Very important,Very important,Moderately important,Moderately important,Very important,Moderately important,Moderately important,Very important,,3.0,4.0,5.0,2.0,6.0,7.0,1.0,"a subsequent review of the ethical approval process for the project found no evidence of harm, discomfort, ridicule or exploitation to the participants",8.0,,,,
96,True,534.0,Reddit,24.0,Male,White / Caucasian,Bachelor's degree,Neutral/ Neither conservative or liberal,Extremely aware,"['… are large and can contain millions of data points', '… reflect events in real-time and can be collected continuously over time', '… are naturalistic in that they do not require researchers to directly interact with research volunteers', '… often capture social relationships not found using traditional methods (e.g. surveys)', '… are readily accessible to researchers and easy to collect']","['Privately messaging users', ""Publicly posting on users' profiles"", 'Creating fake accounts (""bots"")']","['Political elections (e.g. voting behavior)', 'Economic forecasting', 'Presidential approval ratings', 'Health topics (e.g. spread of diseases)', 'Well-being and economic satisfaction', 'Communication (e.g. spread of opinions and hate-speech)', 'Public sentiment (e.g. environment-related concerns)', 'News consumption (e.g. sharing of misinformation)', 'Social networks']",3,3,9,It is in alignment with the institute’s ethics ,Completely acceptable,,,Completely acceptable,,,Completely acceptable,,,Completely acceptable,,,Extremely important,Extremely important,Not at all important,Slightly important,Slightly important,Very important,Moderately important,Extremely important,Slightly important,,3.0,2.0,5.0,4.0,7.0,6.0,1.0,,,,,,
97,True,1956.0,Facebook,44.0,Female,White / Caucasian,Highschool,Very liberal,Not at all aware,"['… are naturalistic in that they do not require researchers to directly interact with research volunteers', '… often capture social relationships not found using traditional methods (e.g. surveys)', '… are readily accessible to researchers and easy to collect']","['Privately messaging users', ""Publicly posting on users' profiles"", 'Creating fake accounts (""bots"")']","['Political elections (e.g. voting behavior)', 'Economic forecasting', 'Presidential approval ratings', 'Health topics (e.g. spread of diseases)', 'Well-being and economic satisfaction', 'News consumption (e.g. sharing of misinformation)', 'Social networks']",1,3,7,that it is appropriate or exceptable to use or to make sure your not violating anyones privacy,Somewhat unacceptable,it help kinda stop some hate speech but still not right to use their info without their knowledge,,Somewhat unacceptable,i feel like that is a invasion of their privacy,,Somewhat acceptable,the people knew it was apart of research so its ok,,Somewhat unacceptable,its not as bad as the first study where they messaged the people but i would still fill like someone took advantage of me,,Extremely important,Not at all important,Extremely important,Moderately important,Not at all important,Extremely important,Very important,Not at all important,Extremely important,,6.0,3.0,4.0,2.0,1.0,7.0,5.0,,,,,,
98,True,779.0,Reddit,66.0,Male,White / Caucasian,Bachelor's degree,Neutral/ Neither conservative or liberal,Moderately aware,"['… are large and can contain millions of data points', '… reflect events in real-time and can be collected continuously over time', '… often capture social relationships not found using traditional methods (e.g. surveys)', '… are readily accessible to researchers and easy to collect']","['Creating fake accounts (""bots"")', 'Secretly changing the content of what users see']","['Political elections (e.g. voting behavior)', 'Well-being and economic satisfaction', 'Communication (e.g. spread of opinions and hate-speech)', 'Public sentiment (e.g. environment-related concerns)', 'News consumption (e.g. sharing of misinformation)', 'Social networks']",2,0,6,"Their review boards have to certify that the experiment conforms to the ethics rules set out by the individual institutions, or governing bodies.",Somewhat acceptable,,,Somewhat unacceptable,"1 it focused on right-wing people only, so it doesn't contain a representative sample",,Completely acceptable,i think this is a good way to conduct the experiment people were informed and compensated,,Somewhat acceptable,,,Very important,Moderately important,Not at all important,Moderately important,Very important,Very important,Very important,Not at all important,Not at all important,whether a truly representative sample is used is it random?,4.0,7.0,6.0,3.0,1.0,5.0,2.0,,,,,,
99,True,1257.0,Reddit,60.0,Female,White / Caucasian,Bachelor's degree,Very liberal,Slightly aware,"['… are large and can contain millions of data points', '… reflect events in real-time and can be collected continuously over time', '… are naturalistic in that they do not require researchers to directly interact with research volunteers', '… often capture social relationships not found using traditional methods (e.g. surveys)', '… are readily accessible to researchers and easy to collect']","['Privately messaging users', 'Creating fake accounts (""bots"")']","['Political elections (e.g. voting behavior)', 'Health topics (e.g. spread of diseases)', 'Well-being and economic satisfaction', 'Communication (e.g. spread of opinions and hate-speech)', 'Public sentiment (e.g. environment-related concerns)', 'News consumption (e.g. sharing of misinformation)', 'Social networks']",3,2,7,I think it means that no one will be harmed by the research.,Somewhat acceptable,"again, the fact that didn't know they were part of a study was somewhat worrying however, since the accounts created for the study were human-operated, it is somewhat less concerning",,Somewhat acceptable,"the subjects weren't aware that they were part of a study, which is somewhat concerning however, it may have been difficult to get accurateinteresting results otherwise",,Completely acceptable,,"no software was installed without the users' approval if it was, it would be unacceptable",Somewhat acceptable,"again, the participants didn't know they were part of a study, but that likely would have influenced the outcome so i find this entirely acceptable",,Moderately important,Very important,Very important,Moderately important,Very important,Moderately important,Extremely important,Extremely important,Not at all important,the installation of apps or extensions to monitor users,6.0,7.0,3.0,2.0,1.0,5.0,4.0,"do nothing (ie, the installation of monitoring software) that could compromise the subject",3.0,,,,
100,True,1298.0,Reddit,26.0,Non-binary / third gender,White / Caucasian,Highschool,Very liberal,Slightly aware,"['… are large and can contain millions of data points', '… reflect events in real-time and can be collected continuously over time', '… are readily accessible to researchers and easy to collect']","['Privately messaging users', 'Creating fake accounts (""bots"")']","['Presidential approval ratings', 'Health topics (e.g. spread of diseases)', 'Communication (e.g. spread of opinions and hate-speech)', 'Public sentiment (e.g. environment-related concerns)', 'News consumption (e.g. sharing of misinformation)', 'Social networks']",1,2,6,That the experiment will not cause undue harm to perform,Completely acceptable,,,Somewhat acceptable,the fact that a private message was sent is slightly of concern while not unethical it doesn't sit super well with me that messages are being sent unsolicited,i ultimately find the study ethical because the private message was simply a survey question if it was like a statement or comment about the persontheir tweets like the other studies did (although they were public) i would probably consider it harassment,Completely acceptable,,,Completely acceptable,,,Not at all important,Not at all important,Not at all important,Not at all important,Not at all important,Very important,Slightly important,Not at all important,Not at all important,one thing that is also concerning is use of social media by minors most sites are 13+ and it's not always possible for researcher's to determine a user's real age while i generally believe research on public profilestweets is ethical i don't think this really applies to minors and i have concerns about their data being collectedused,7.0,6.0,5.0,2.0,1.0,3.0,4.0,,,,,,
101,True,1018.0,Facebook,40.0,Female,White / Caucasian,Bachelor's degree,Very liberal,Moderately aware,"['… are large and can contain millions of data points', '… reflect events in real-time and can be collected continuously over time', '… are naturalistic in that they do not require researchers to directly interact with research volunteers', '… often capture social relationships not found using traditional methods (e.g. surveys)', '… are readily accessible to researchers and easy to collect']","['Creating fake accounts (""bots"")']","['Political elections (e.g. voting behavior)', 'Economic forecasting', 'Health topics (e.g. spread of diseases)', 'Communication (e.g. spread of opinions and hate-speech)', 'Public sentiment (e.g. environment-related concerns)', 'News consumption (e.g. sharing of misinformation)', 'Social networks']",3,1,7,"They have to submit their proposal to their IRB, which checks it for things like informed consent, data security, etc. ",Somewhat acceptable,"same as my reply to the question before last - the participants are not aware that they are in a research study, but since it's nothing they wouldn't encounter in normal everyday life i'm not sure how important that is","not sure again, revealing that is a study may influence the results",Somewhat unacceptable,participants are not aware they are in a study,"ask for informed consent when sending the private message, debrief on true intent after study is over",Somewhat unacceptable,"it is unclear if the study participants knew they were being tracked if they installed the browser extension additionally, all participants should have access to study results - it should not be offered as compensation also, it appears participants did not know the true intent of the study if so, they should have been debriefed at the end",as noted above - what the participants knew about the extent of the study and browser tracking and whether they were debriefed at the end,Somewhat acceptable,"since this is something that can and does happen outside of the research sphere, i'm not sure that there are any major ethical issues, but something about it rubs me the wrong way i guess because there is an attempt to influence people without their knowledge","i'm not sure i feel like anything that would be done to make it more ethical would make the study less effective (like, by telling the original poster why the fact checking tweet was being posted)",Slightly important,Not at all important,Not at all important,Slightly important,Slightly important,Very important,Extremely important,Very important,Slightly important,,7.0,2.0,4.0,1.0,3.0,5.0,6.0,,,,,,
102,True,849.0,Reddit,47.0,Female,White / Caucasian,Highschool,Very liberal,Slightly aware,"['… reflect events in real-time and can be collected continuously over time', '… are naturalistic in that they do not require researchers to directly interact with research volunteers', '… often capture social relationships not found using traditional methods (e.g. surveys)', '… are readily accessible to researchers and easy to collect']","['Privately messaging users', ""Publicly posting on users' profiles"", 'Creating fake accounts (""bots"")', 'Secretly changing the content of what users see']","['Political elections (e.g. voting behavior)', 'Economic forecasting', 'Presidential approval ratings', 'Health topics (e.g. spread of diseases)', 'Well-being and economic satisfaction', 'Communication (e.g. spread of opinions and hate-speech)', 'Public sentiment (e.g. environment-related concerns)', 'News consumption (e.g. sharing of misinformation)', 'Social networks']",2,2,9,It means that they are doing the survey in an ethical way.,Somewhat acceptable,,,Somewhat acceptable,,,Somewhat acceptable,,,Somewhat acceptable,,,Slightly important,Not at all important,Not at all important,Not at all important,Not at all important,Not at all important,Slightly important,Not at all important,Slightly important,is their privacy protected?if they don't know that they are part of research that also means they aren't being paid for it,6.0,2.0,3.0,1.0,4.0,7.0,5.0,,,,,,
103,True,761.0,Facebook,38.0,Male,White / Caucasian,Bachelor's degree,Neutral/ Neither conservative or liberal,Moderately aware,"['… are large and can contain millions of data points', '… reflect events in real-time and can be collected continuously over time', '… are naturalistic in that they do not require researchers to directly interact with research volunteers', '… often capture social relationships not found using traditional methods (e.g. surveys)', '… are readily accessible to researchers and easy to collect']","['Privately messaging users', ""Publicly posting on users' profiles"", 'Creating fake accounts (""bots"")']","['Political elections (e.g. voting behavior)', 'Economic forecasting', 'Presidential approval ratings', 'Health topics (e.g. spread of diseases)', 'Well-being and economic satisfaction', 'Communication (e.g. spread of opinions and hate-speech)', 'Public sentiment (e.g. environment-related concerns)', 'News consumption (e.g. sharing of misinformation)', 'Social networks']",3,3,9,That a board of peers say it’s ok and ethical,Completely acceptable,,,Somewhat acceptable,,to let users know there are using their data,Completely acceptable,,,Somewhat acceptable,,,Very important,Slightly important,Very important,Slightly important,Slightly important,Moderately important,Very important,Moderately important,Moderately important,,7.0,3.0,4.0,5.0,1.0,6.0,2.0,,,,,,
104,True,559.0,Facebook,36.0,Male,White / Caucasian,Bachelor's degree,Slightly conservative,Extremely aware,"['… are large and can contain millions of data points', '… reflect events in real-time and can be collected continuously over time', '… are naturalistic in that they do not require researchers to directly interact with research volunteers', '… are readily accessible to researchers and easy to collect', '… are always representative of people’s offline behavior']","[""Publicly posting on users' profiles"", 'Creating fake accounts (""bots"")', ""Hacking into users' accounts""]","['Political elections (e.g. voting behavior)', 'Economic forecasting', 'Presidential approval ratings', 'Public sentiment (e.g. environment-related concerns)', 'News consumption (e.g. sharing of misinformation)', 'Social networks']",1,1,6,Not a fan of anything along those lines. But being politically correct in material so it doesn't offend other ethnicities. ,Neutral,,,Somewhat unacceptable,"i mean it wouldn't offend me too much because i'm not a big social media person however, would be annoyed if this happened to a friend or family member of mine",,Somewhat acceptable,,,Neutral,,,Extremely important,Slightly important,Moderately important,Very important,Moderately important,Not at all important,Slightly important,Moderately important,Slightly important,mostly extremely private data that could be hijacked like a social security number,7.0,2.0,5.0,1.0,4.0,3.0,6.0,,,,,,
105,True,623.0,Twitter,30.0,Male,White / Caucasian,Highschool,Slightly liberal,Slightly aware,"['… are large and can contain millions of data points', '… reflect events in real-time and can be collected continuously over time', '… are naturalistic in that they do not require researchers to directly interact with research volunteers', '… often capture social relationships not found using traditional methods (e.g. surveys)']","['Privately messaging users', 'Creating fake accounts (""bots"")']","['Political elections (e.g. voting behavior)', 'Economic forecasting', 'Health topics (e.g. spread of diseases)', 'Public sentiment (e.g. environment-related concerns)', 'News consumption (e.g. sharing of misinformation)', 'Social networks']",4,2,6,To use only ethical means to collect and publish research data,Somewhat acceptable,,,Somewhat acceptable,,,Somewhat acceptable,,,Somewhat acceptable,,,Extremely important,Very important,Extremely important,Slightly important,Moderately important,Slightly important,Moderately important,Extremely important,Very important,,5.0,4.0,6.0,2.0,1.0,7.0,3.0,,,,,,
106,True,331.0,Twitter,21.0,Male,Asian - Eastern,Highschool,Slightly liberal,Moderately aware,"['… are large and can contain millions of data points', '… reflect events in real-time and can be collected continuously over time', '… are readily accessible to researchers and easy to collect']","['Privately messaging users', 'Creating fake accounts (""bots"")', 'Secretly changing the content of what users see']","['Economic forecasting', 'Health topics (e.g. spread of diseases)', 'Well-being and economic satisfaction', 'Social networks']",1,1,4,Whether their methods of collecting data are ethical.,Completely acceptable,,,Somewhat acceptable,,,Neutral,,,Completely acceptable,,,Moderately important,Not at all important,Extremely important,Moderately important,Slightly important,Very important,Very important,Very important,Extremely important,,5.0,2.0,6.0,1.0,3.0,7.0,4.0,,,,,,
107,True,263.0,Reddit,26.0,Female,White / Caucasian,Bachelor's degree,Very liberal,Extremely aware,"['… reflect events in real-time and can be collected continuously over time', '… often capture social relationships not found using traditional methods (e.g. surveys)']",['None of the above'],"['Economic forecasting', 'Health topics (e.g. spread of diseases)', 'Communication (e.g. spread of opinions and hate-speech)', 'Public sentiment (e.g. environment-related concerns)', 'News consumption (e.g. sharing of misinformation)', 'Social networks']",2,0,6,I think it just means that they don't believe what they are doing will hurt anyone.,Completely acceptable,,,Completely acceptable,,,Completely acceptable,,,Completely acceptable,,,Slightly important,Not at all important,Moderately important,Slightly important,Not at all important,Not at all important,Moderately important,Slightly important,Moderately important,,6.0,3.0,7.0,2.0,4.0,1.0,5.0,,,,,,
108,True,370.0,Reddit,35.0,Non-binary / third gender,White / Caucasian,Master's degree or above,Neutral/ Neither conservative or liberal,Moderately aware,"['… are large and can contain millions of data points', '… reflect events in real-time and can be collected continuously over time', '… are readily accessible to researchers and easy to collect']","[""Publicly posting on users' profiles"", 'Creating fake accounts (""bots"")']","['Political elections (e.g. voting behavior)', 'Presidential approval ratings', 'Health topics (e.g. spread of diseases)', 'Well-being and economic satisfaction', 'Communication (e.g. spread of opinions and hate-speech)', 'Public sentiment (e.g. environment-related concerns)', 'News consumption (e.g. sharing of misinformation)']",1,2,7,"Their protocol must be approved by a special committee designed by the respective institution, where it's stated the purpose of the study and how they manipulate the subjects and data",Completely acceptable,,,Neutral,,,Somewhat unacceptable,,,Completely acceptable,,,Extremely important,Extremely important,Extremely important,Very important,Very important,Very important,Moderately important,Moderately important,Very important,,4.0,1.0,3.0,2.0,5.0,6.0,7.0,,10.0,None,9.0,,8.0
109,True,707.0,Reddit,23.0,Female,Asian - Eastern,Bachelor's degree,Slightly liberal,Moderately aware,"['… are large and can contain millions of data points', '… reflect events in real-time and can be collected continuously over time', '… are naturalistic in that they do not require researchers to directly interact with research volunteers', '… often capture social relationships not found using traditional methods (e.g. surveys)', '… are readily accessible to researchers and easy to collect']","['Privately messaging users', 'Creating fake accounts (""bots"")']","['Political elections (e.g. voting behavior)', 'Economic forecasting', 'Presidential approval ratings', 'Health topics (e.g. spread of diseases)', 'Well-being and economic satisfaction', 'Communication (e.g. spread of opinions and hate-speech)', 'Public sentiment (e.g. environment-related concerns)', 'News consumption (e.g. sharing of misinformation)', 'Social networks']",3,2,9,It means that the institution is aware of the research study and thinks that it falls under specific ethical guidelines. It doesn't go outside of what is reasonable.,Somewhat acceptable,"it seems manipulative, but in a positive way","i'm curious about how many other people observed the experiment without knowing what it was for example, i want to know how many people saw these replies",Neutral,"i think this would make more sense if it included both far-left and far-right posts, since it seems politically biased like this",i'm curious why the researchers focused only on far-right posts,Completely acceptable,"it's good that the researchers tried to get people to look at a bigger variety of news sources, rather than just ones that they had the same opinions as",,Somewhat acceptable,"i think the idea behind this message is good, since the researchers wanted to point out false information however, the results weren't what they hoped for",,Moderately important,Not at all important,Moderately important,Slightly important,Moderately important,Very important,Very important,Slightly important,Very important,"if people are focusing on just far-right or far-left posts, it implies some political bias behind the research study i think the researchers should include both ends of the political spectrum",7.0,5.0,1.0,3.0,6.0,4.0,2.0,ensuring that the study design has no personal bias from the researchers,3.0,,,,
110,True,1108.0,Facebook,55.0,Female,White / Caucasian,Master's degree or above,Neutral/ Neither conservative or liberal,Slightly aware,"['… are large and can contain millions of data points', '… reflect events in real-time and can be collected continuously over time', '… are naturalistic in that they do not require researchers to directly interact with research volunteers', '… often capture social relationships not found using traditional methods (e.g. surveys)', '… are readily accessible to researchers and easy to collect']","['Privately messaging users', ""Publicly posting on users' profiles""]","['Political elections (e.g. voting behavior)', 'Economic forecasting', 'Presidential approval ratings', 'Health topics (e.g. spread of diseases)', 'Well-being and economic satisfaction', 'Communication (e.g. spread of opinions and hate-speech)', 'Public sentiment (e.g. environment-related concerns)', 'News consumption (e.g. sharing of misinformation)', 'Social networks']",3,2,9,"They would put together a proposal and outline how they would obtain the data and how it would be used, and they would attest to the fact that they would not use any methods that are misleading, unethical or morally wrong.  ",Completely acceptable,,,Somewhat acceptable,,,Somewhat acceptable,even though they were upfront about collecting the data (using the browser extension) it kind of seems like they took advantage of participants because the incentive that was offered was very low,,Somewhat unacceptable,it seems a little unethical that accounts were made to look like human accounts and people did not know this or know that they were part of a study,,Very important,Not at all important,Slightly important,Slightly important,Extremely important,Extremely important,Moderately important,Slightly important,Very important,i think also important is whether users understand how their data will be used when they give permission for researchers to actively track their online behavior,6.0,3.0,7.0,2.0,1.0,5.0,4.0,,,,,,
111,True,704.0,Reddit,27.0,Male,Hispanic,Highschool,Neutral/ Neither conservative or liberal,Very aware,"['… are large and can contain millions of data points', '… reflect events in real-time and can be collected continuously over time', '… are naturalistic in that they do not require researchers to directly interact with research volunteers', '… often capture social relationships not found using traditional methods (e.g. surveys)', '… are readily accessible to researchers and easy to collect']","['Privately messaging users', ""Publicly posting on users' profiles"", 'Creating fake accounts (""bots"")']","['Political elections (e.g. voting behavior)', 'Communication (e.g. spread of opinions and hate-speech)', 'Public sentiment (e.g. environment-related concerns)', 'News consumption (e.g. sharing of misinformation)']",3,3,4,possibly asking for just enough permission,Completely acceptable,,,Completely acceptable,the only thing is why only right leaning websites why not both sides,,Completely acceptable,same as the other one it doesn't feel like manipulation so it feels ethical to me,,Completely acceptable,i think the study was fine as it didn't manipulate people,,Extremely important,Not at all important,Extremely important,Not at all important,Slightly important,Moderately important,Not at all important,Moderately important,Extremely important,,7.0,6.0,4.0,3.0,1.0,5.0,2.0,,10.0,,10.0,,10.0
112,True,467.0,Twitter,35.0,Male,White / Caucasian,Highschool,Slightly conservative,Not at all aware,['… are naturalistic in that they do not require researchers to directly interact with research volunteers'],['None of the above'],"['Political elections (e.g. voting behavior)', 'Economic forecasting', 'Presidential approval ratings', 'Health topics (e.g. spread of diseases)', 'Public sentiment (e.g. environment-related concerns)']",1,0,5,Asking permission before doing so I would say.,Somewhat acceptable,,,Somewhat acceptable,,,Completely acceptable,,,Neutral,,,Moderately important,Slightly important,Moderately important,Slightly important,Very important,Very important,Very important,Moderately important,Moderately important,,6.0,4.0,2.0,5.0,7.0,1.0,3.0,,,,,,
113,True,403.0,Facebook,30.0,Female,White / Caucasian,Master's degree or above,Slightly liberal,Very aware,"['… are large and can contain millions of data points', '… often capture social relationships not found using traditional methods (e.g. surveys)']",['None of the above'],['None of the above'],2,0,0,Consent from users on what info they have access to ,Somewhat unacceptable,i don’t think it’s ethical if people are unaware they’re in a study,,Somewhat unacceptable,people should be informed of the study before,,Completely acceptable,,,Somewhat unacceptable,people being unaware and the fake human accounts,,Slightly important,Not at all important,Slightly important,Slightly important,Not at all important,Very important,Extremely important,Not at all important,Slightly important,,6.0,4.0,1.0,5.0,3.0,2.0,7.0,,,,,,
114,True,472.0,Facebook,34.0,Female,White / Caucasian,Highschool,Very conservative,Extremely aware,"['… are large and can contain millions of data points', '… reflect events in real-time and can be collected continuously over time', '… are naturalistic in that they do not require researchers to directly interact with research volunteers', '… often capture social relationships not found using traditional methods (e.g. surveys)', '… are readily accessible to researchers and easy to collect']",['None of the above'],"['Political elections (e.g. voting behavior)', 'Presidential approval ratings', 'Health topics (e.g. spread of diseases)', 'Well-being and economic satisfaction', 'Communication (e.g. spread of opinions and hate-speech)', 'News consumption (e.g. sharing of misinformation)']",3,0,6,"I have no idea what ethical approval is
",Neutral,,,Completely unacceptable,why were the people unaware? why didn't liberal accounts get studied as well?,,Neutral,,,Neutral,,,Very important,Very important,Very important,Extremely important,Moderately important,Moderately important,Very important,Moderately important,Very important,"as long as it isn't all one-sided i have seen more hate from the left than i have from the right i'm not saying there isn't hate from the right, but liberals are run by their emotions",5.0,4.0,7.0,6.0,1.0,3.0,2.0,,,,,,
115,True,780.0,Reddit,57.0,Male,White / Caucasian,Bachelor's degree,Neutral/ Neither conservative or liberal,Slightly aware,"['… reflect events in real-time and can be collected continuously over time', '… often capture social relationships not found using traditional methods (e.g. surveys)']",['Privately messaging users'],['Public sentiment (e.g. environment-related concerns)'],2,1,1,It means having others tellyou waht methods are acceptable and are not.,Somewhat acceptable,if it works to reduce hate speech then it is acceptable,,Somewhat acceptable,seem plausible  i'd want more information,did they reveal a purpose for the messages--truthful or not,Neutral,,,Somewhat acceptable,i think this would work but i need more information,,Extremely important,Extremely important,Very important,Moderately important,Very important,Very important,Extremely important,Extremely important,Extremely important,social media only reaches part o f the population so this method intrinsically is flawed if it is trying to represent the population as a whole  the vast majority of the world does not have a social media account  this is a very exclusive slant to research and only applies to a certain demographic,6.0,4.0,5.0,3.0,1.0,7.0,2.0,,1.0,,2.0,,3.0
116,True,633.0,Reddit,27.0,Male,Hispanic,Highschool,Slightly liberal,Not at all aware,"['… are large and can contain millions of data points', '… reflect events in real-time and can be collected continuously over time', '… are naturalistic in that they do not require researchers to directly interact with research volunteers', '… often capture social relationships not found using traditional methods (e.g. surveys)', '… are readily accessible to researchers and easy to collect']","['Privately messaging users', 'Creating fake accounts (""bots"")', 'Secretly changing the content of what users see']","['Political elections (e.g. voting behavior)', 'Economic forecasting', 'Presidential approval ratings', 'Health topics (e.g. spread of diseases)', 'Well-being and economic satisfaction', 'Communication (e.g. spread of opinions and hate-speech)', 'Public sentiment (e.g. environment-related concerns)', 'News consumption (e.g. sharing of misinformation)', 'Social networks']",3,1,9,"Ethical approval in my opinion, would be that all parties involved understand what is taking place and the risks involved.",Somewhat acceptable,,,Somewhat unacceptable,,,Somewhat acceptable,,,Somewhat unacceptable,,,Moderately important,Extremely important,Extremely important,Very important,Slightly important,Moderately important,Extremely important,Very important,Very important,,7.0,2.0,4.0,3.0,6.0,5.0,1.0,,,,,,
117,True,527.0,Facebook,30.0,Female,White / Caucasian,Master's degree or above,Slightly liberal,Very aware,"['… are large and can contain millions of data points', '… are naturalistic in that they do not require researchers to directly interact with research volunteers', '… are readily accessible to researchers and easy to collect']","['Privately messaging users', 'Secretly changing the content of what users see']","['Presidential approval ratings', 'Health topics (e.g. spread of diseases)', 'Well-being and economic satisfaction', 'Public sentiment (e.g. environment-related concerns)', 'News consumption (e.g. sharing of misinformation)', 'Social networks']",1,0,6,"Ethical approval means asking the local IRB to approve your methods and laying bare the exact procedure of your experiment. This includes every step and how many people are involved, as well as consent forms if required.",Somewhat acceptable,"as long as their replies were not rude or mean, i think this is fine it would be something that happens on twitter anyway my only concern is was every public reply the same? aka was it easy to find out if that account was involved?",None,Somewhat acceptable,it does a good dead however you are still spamming people with a message this is not illegal though,,Completely acceptable,,,Somewhat acceptable,"not much to say, lacks consent but as its only a public reply there is no invasion of privacy or any wrongdoing",,Very important,Very important,Extremely important,Moderately important,Moderately important,Very important,Very important,Moderately important,Extremely important,whether there is an invasion of privacy,7.0,4.0,3.0,2.0,1.0,6.0,5.0,,,,,,
118,True,941.0,Facebook,29.0,Female,White / Caucasian,Bachelor's degree,Slightly liberal,Very aware,"['… are large and can contain millions of data points', '… reflect events in real-time and can be collected continuously over time', '… are readily accessible to researchers and easy to collect']","['Privately messaging users', 'Creating fake accounts (""bots"")', 'Secretly changing the content of what users see']","['Political elections (e.g. voting behavior)', 'Presidential approval ratings', 'Well-being and economic satisfaction', 'Communication (e.g. spread of opinions and hate-speech)', 'Public sentiment (e.g. environment-related concerns)', 'Social networks']",1,1,6,Make sure they are not getting sensitive data and that people involved are treated fairly ,Somewhat acceptable,"people were unaware they were being studied, but it is social media so everything is public anyway",,Completely acceptable,as long as the private messages were civil it is ok,,Somewhat acceptable,the downloaded web browser extension could be bad if they were looking at other sites other than for the study,make sure the extension is deleted after the study,Completely acceptable,,,Extremely important,Slightly important,Very important,Slightly important,Very important,Very important,Very important,Moderately important,Extremely important,,5.0,6.0,7.0,3.0,1.0,4.0,2.0,,,,,,
119,True,1165.0,Facebook,56.0,Male,White / Caucasian,Bachelor's degree,Slightly liberal,Not at all aware,"['… are large and can contain millions of data points', '… reflect events in real-time and can be collected continuously over time', '… are readily accessible to researchers and easy to collect']","[""Publicly posting on users' profiles""]","['Well-being and economic satisfaction', 'Public sentiment (e.g. environment-related concerns)', 'News consumption (e.g. sharing of misinformation)']",1,1,3,Ethical approval means getting approval to make sure the experiments are are used for the the better good for society.,Somewhat acceptable,,,Somewhat acceptable,,,Completely acceptable,,,Completely acceptable,i think it was a well thought out experiment there is so much misinformation out there and people keep on spreading it,,Very important,Very important,Very important,Moderately important,Moderately important,Very important,Very important,Moderately important,Extremely important,,5.0,2.0,6.0,1.0,4.0,7.0,3.0,,,,,,
120,True,879.0,Reddit,38.0,Male,White / Caucasian,Highschool,Very liberal,Slightly aware,"['… are large and can contain millions of data points', '… reflect events in real-time and can be collected continuously over time', '… are naturalistic in that they do not require researchers to directly interact with research volunteers', '… often capture social relationships not found using traditional methods (e.g. surveys)', '… are readily accessible to researchers and easy to collect']","['Privately messaging users', ""Publicly posting on users' profiles"", 'Creating fake accounts (""bots"")']","['Political elections (e.g. voting behavior)', 'Economic forecasting', 'Presidential approval ratings', 'Health topics (e.g. spread of diseases)', 'Well-being and economic satisfaction', 'Communication (e.g. spread of opinions and hate-speech)', 'Public sentiment (e.g. environment-related concerns)', 'News consumption (e.g. sharing of misinformation)', 'Social networks']",3,3,9,They go to an Institutional Review Board (or a similar group depending on where the institution operates) and present the process for their proposed research. It's evaluated based on a set of guidelines with a eye on the safety and privacy of participants. ,Completely acceptable,i don't see any problem with this,,Completely acceptable,"once again, this appears to be very similar to the last two i don't have a problem, ethically, with contacting people on social media in any way",,Completely unacceptable,"the payment for this amount of private information is not nearly enough i think fair compensation for time is a part of the ethical requirement for research, and this does not meet that requirement",,Completely acceptable,"this seems basically the same as the last one, as far as ethics are concerned",,Extremely important,Not at all important,Not at all important,Not at all important,Not at all important,Extremely important,Not at all important,Not at all important,Moderately important,"i will say that for me personally, anything a user says or does publicly on social media is fair game as is contacting them if the settings they've chosen allow it these things are part and parcel of using social media, and don't need or deserve any notification or compensation however, when you start to collect private information, install software, or anything else beyond the expected scope of regular social media interactions, i think there needs to be much more scrutiny on fair treatment and fair compensation",7.0,5.0,2.0,3.0,1.0,6.0,4.0,,,,,,
121,True,527.0,Twitter,30.0,Male,White / Caucasian,Bachelor's degree,Neutral/ Neither conservative or liberal,Moderately aware,"['… reflect events in real-time and can be collected continuously over time', '… are readily accessible to researchers and easy to collect']","['Privately messaging users', 'Creating fake accounts (""bots"")', 'Secretly changing the content of what users see', ""Hacking into users' accounts""]","['Political elections (e.g. voting behavior)', 'Economic forecasting', 'Presidential approval ratings', 'Health topics (e.g. spread of diseases)', 'Well-being and economic satisfaction', 'Communication (e.g. spread of opinions and hate-speech)', 'Public sentiment (e.g. environment-related concerns)', 'News consumption (e.g. sharing of misinformation)', 'Social networks']",0,0,9,It sounds like a vague blessing of tactics that could differ from institution to institution,Somewhat unacceptable,participants did not consent to be a part of the study,,Completely unacceptable,"participants did not consent, there was no study of left-leaning fake news",,Somewhat unacceptable,it was extremely underpaying and results should not be withheld,conversations in the planning phase,Somewhat unacceptable,,,Very important,Moderately important,Moderately important,Moderately important,Very important,Moderately important,Very important,Very important,Moderately important,,6.0,1.0,4.0,2.0,5.0,7.0,3.0,,,,,,
122,True,501.0,Facebook,29.0,Female,White / Caucasian,Master's degree or above,Very liberal,Slightly aware,"['… are large and can contain millions of data points', '… reflect events in real-time and can be collected continuously over time', '… are readily accessible to researchers and easy to collect']",['None of the above'],"['Communication (e.g. spread of opinions and hate-speech)', 'Public sentiment (e.g. environment-related concerns)', 'News consumption (e.g. sharing of misinformation)', 'Social networks']",1,0,4,That the way that the study is run is ethical for the person completing the study.,Neutral,,,Neutral,"i think that people should have to consent to be in a study, but if no personal information was collected and there was a choice to not read the message then it's okay?",,Somewhat acceptable,,,Neutral,,,Moderately important,Slightly important,Slightly important,Slightly important,Not at all important,Not at all important,Extremely important,Not at all important,Extremely important,it's hard to tell what is real on social media,7.0,3.0,4.0,1.0,2.0,6.0,5.0,,,,,,
123,True,974.0,Twitter,26.0,Male,Asian - Indian,Bachelor's degree,Slightly conservative,Slightly aware,"['… are large and can contain millions of data points', '… reflect events in real-time and can be collected continuously over time', '… often capture social relationships not found using traditional methods (e.g. surveys)', '… are readily accessible to researchers and easy to collect']",['None of the above'],"['Political elections (e.g. voting behavior)', 'Economic forecasting', 'Health topics (e.g. spread of diseases)', 'Well-being and economic satisfaction', 'Communication (e.g. spread of opinions and hate-speech)', 'News consumption (e.g. sharing of misinformation)']",2,0,6,Ethical approval means to adhere ethical standards of a genuine research study.,Completely acceptable,i appreciate this way to minimize online hate speech,,Completely acceptable,,,Somewhat acceptable,,,Somewhat acceptable,,,Very important,Slightly important,Very important,Not at all important,Moderately important,Not at all important,Moderately important,Slightly important,Very important,researchers should try to play smart by organizing trends on twitter to collect more active data,3.0,4.0,1.0,5.0,2.0,7.0,6.0,respect the time of the participant,8.0,ensure payments alongside bonus,9.0,,10.0
124,True,669.0,Reddit,50.0,Male,White / Caucasian,Highschool,Very liberal,Moderately aware,"['… are large and can contain millions of data points', '… often capture social relationships not found using traditional methods (e.g. surveys)', '… are readily accessible to researchers and easy to collect']","['Creating fake accounts (""bots"")']","['Political elections (e.g. voting behavior)', 'Economic forecasting', 'Presidential approval ratings', 'Health topics (e.g. spread of diseases)', 'Public sentiment (e.g. environment-related concerns)', 'News consumption (e.g. sharing of misinformation)']",1,1,6,That whatever they're doing doesn't what most people to be moral--nothing illegal or misleading--more than what's needed for the experiment,Neutral,,,Somewhat unacceptable,concerned that the pm's may have been unethical or at least the users thought they were being by the platform,,Somewhat unacceptable,always concerned when something asks to install something--and promise of payment can skew results,,Somewhat acceptable,,,Slightly important,Moderately important,Slightly important,Very important,Very important,Moderately important,Moderately important,Moderately important,Very important,"again, concerned that promises of payment can cause issues--users may behave differently than they normally would because there is a bonus for them",3.0,4.0,7.0,1.0,6.0,5.0,2.0,"what could happen ifwhen the 'participant' learns that they were being monitoredused for an experiment--will they lash out or just distrust academia, feeling they were in some way 'duped'",3.0,,,,
125,True,650.0,Reddit,31.0,Male,White / Caucasian,Bachelor's degree,Very liberal,Very aware,"['… are large and can contain millions of data points', '… reflect events in real-time and can be collected continuously over time', '… are naturalistic in that they do not require researchers to directly interact with research volunteers', '… often capture social relationships not found using traditional methods (e.g. surveys)', '… are readily accessible to researchers and easy to collect']","['Privately messaging users', ""Publicly posting on users' profiles"", 'Creating fake accounts (""bots"")', 'Secretly changing the content of what users see']","['Political elections (e.g. voting behavior)', 'Economic forecasting', 'Presidential approval ratings', 'Health topics (e.g. spread of diseases)', 'Well-being and economic satisfaction', 'Communication (e.g. spread of opinions and hate-speech)', 'Public sentiment (e.g. environment-related concerns)', 'News consumption (e.g. sharing of misinformation)', 'Social networks']",3,2,9,This would be checks to ensure that all participants are treated fairly and not discriminated against; they would also normally have the right to withdraw their data. ,Completely acceptable,,,Completely acceptable,,,Completely acceptable,participants were paid far too little for the amount of sensitive data they gave to researchers,,Completely acceptable,,,Extremely important,Extremely important,Extremely important,Extremely important,Extremely important,Very important,Extremely important,Very important,Extremely important,,7.0,2.0,3.0,4.0,1.0,6.0,5.0,,,,,,
126,True,789.0,Twitter,52.0,Female,White / Caucasian,Associate's degree,Very liberal,Very aware,"['… are large and can contain millions of data points', '… often capture social relationships not found using traditional methods (e.g. surveys)', '… are readily accessible to researchers and easy to collect']","['Privately messaging users', 'Creating fake accounts (""bots"")']","['Political elections (e.g. voting behavior)', 'Communication (e.g. spread of opinions and hate-speech)', 'Public sentiment (e.g. environment-related concerns)', 'News consumption (e.g. sharing of misinformation)', 'Social networks']",1,2,5,The study is submitted to either a board or supervising body that reviews the study to ensure it meets the international standards as set down.,Somewhat acceptable,,,Neutral,,,Completely acceptable,,,Neutral,,,Very important,Slightly important,Very important,Moderately important,Very important,Very important,Moderately important,Very important,Very important,"is the researcg significantly negatively affecting the participant, especially if uninformed",7.0,6.0,5.0,3.0,1.0,2.0,4.0,,9.0,,,,
127,True,667.0,Facebook,31.0,Female,White / Caucasian,Bachelor's degree,Very liberal,Slightly aware,['… often capture social relationships not found using traditional methods (e.g. surveys)'],"['Privately messaging users', 'Creating fake accounts (""bots"")']","['Presidential approval ratings', 'Health topics (e.g. spread of diseases)', 'Well-being and economic satisfaction', 'Public sentiment (e.g. environment-related concerns)', 'Social networks']",1,2,5,I think it is getting the okay that the study is safe to run and causes no harm. ,Neutral,,,Somewhat acceptable,,,Somewhat acceptable,,,Neutral,,,Slightly important,Slightly important,Slightly important,Moderately important,Slightly important,Very important,Very important,Moderately important,Moderately important,,7.0,2.0,4.0,3.0,1.0,6.0,5.0,,,,,,
128,True,876.0,Facebook,37.0,Female,White / Caucasian,Highschool,Slightly conservative,Not at all aware,"['… are large and can contain millions of data points', '… reflect events in real-time and can be collected continuously over time', '… are naturalistic in that they do not require researchers to directly interact with research volunteers', '… often capture social relationships not found using traditional methods (e.g. surveys)', '… are readily accessible to researchers and easy to collect']","['Privately messaging users', ""Publicly posting on users' profiles"", 'Creating fake accounts (""bots"")']","['Political elections (e.g. voting behavior)', 'Economic forecasting', 'Presidential approval ratings', 'Health topics (e.g. spread of diseases)', 'Well-being and economic satisfaction', 'Communication (e.g. spread of opinions and hate-speech)', 'Public sentiment (e.g. environment-related concerns)', 'News consumption (e.g. sharing of misinformation)', 'Social networks']",3,3,9,I think ethical approval would be the institution reviews the research plan to ensure that it does not pose any threat or will cause any harm to those involved. ,Completely acceptable,,,Completely acceptable,,curious if this was also done with left leaning users and if they had the same outcome,Completely acceptable,,,Completely acceptable,,,Not at all important,Not at all important,Not at all important,Not at all important,Not at all important,Not at all important,Not at all important,Not at all important,Not at all important,i feel that anyone that uses social media allows themselves to be open to anyone or anything there should be that level of understanding from a user so i don't see anything wrong with social experiments or studies done by researchers of course within legal parameters,7.0,4.0,6.0,3.0,1.0,5.0,2.0,,,,,,
129,True,507.0,Twitter,38.0,Male,White / Caucasian,Master's degree or above,Very liberal,Slightly aware,"['… are large and can contain millions of data points', '… reflect events in real-time and can be collected continuously over time', '… are naturalistic in that they do not require researchers to directly interact with research volunteers', '… often capture social relationships not found using traditional methods (e.g. surveys)', '… are readily accessible to researchers and easy to collect']","[""Publicly posting on users' profiles"", 'Creating fake accounts (""bots"")']","['Economic forecasting', 'Health topics (e.g. spread of diseases)', 'Well-being and economic satisfaction', 'Communication (e.g. spread of opinions and hate-speech)', 'Public sentiment (e.g. environment-related concerns)', 'News consumption (e.g. sharing of misinformation)', 'Social networks']",3,2,7,I think it means that a research proposal is presented to an ethics board which verifies that it meets the ethical standards set forth by either the research body or an independent council.  ,Somewhat unacceptable,"i think my only major concern was that the participants were not made aware they were part of the study, that to me seems unethical",,Neutral,"i think my issue here is, again, they were not notified about the research but they were only sent a survey, there was no deception involved, so i am unsure",i would like to see the text of the private message,Completely acceptable,"i have no concerns about this study, the participants had full knowledge that they were part of a study and entered in with consent",,Completely unacceptable,the deception (bots posing as humans) as well as the participants not knowing they were part of an experiment to me is unethical,,Extremely important,Moderately important,Slightly important,Slightly important,Moderately important,Extremely important,Extremely important,Very important,Slightly important,,7.0,2.0,1.0,3.0,4.0,5.0,6.0,,,,,,
130,True,572.0,Twitter,64.0,Female,White / Caucasian,Highschool,Slightly liberal,Not at all aware,"['… are large and can contain millions of data points', '… often capture social relationships not found using traditional methods (e.g. surveys)', '… are readily accessible to researchers and easy to collect']","[""Publicly posting on users' profiles""]","['Political elections (e.g. voting behavior)', 'Economic forecasting', 'Presidential approval ratings', 'Health topics (e.g. spread of diseases)', 'Well-being and economic satisfaction', 'Communication (e.g. spread of opinions and hate-speech)', 'Public sentiment (e.g. environment-related concerns)', 'News consumption (e.g. sharing of misinformation)', 'Social networks']",1,1,9,"Someone in their institution decides whether it's acceptable according the to institutions standards, whatever they may be.  I would think each institution would be different, rather than there being a set standard.",Completely unacceptable,manipulating people without their consent is unethical,,Completely unacceptable,,,Completely unacceptable,"while the participants knew about it, no one reading the ""likes"" was aware still manipulating the system",,Completely unacceptable,"horrible, if true no reason to make things more inflammatory, let alone doing it without anyone's knowledge",,Extremely important,Extremely important,Extremely important,Extremely important,Extremely important,Extremely important,Extremely important,Extremely important,Extremely important,"any of it is highly suspect, and i don't think it's ethical at all",5.0,6.0,4.0,7.0,2.0,3.0,1.0,,,,,,
131,True,1137.0,Facebook,31.0,Female,White / Caucasian,Master's degree or above,Very liberal,Slightly aware,"['… are large and can contain millions of data points', '… are naturalistic in that they do not require researchers to directly interact with research volunteers', '… often capture social relationships not found using traditional methods (e.g. surveys)', '… are readily accessible to researchers and easy to collect']","[""Publicly posting on users' profiles"", 'Creating fake accounts (""bots"")', 'Secretly changing the content of what users see']","['Communication (e.g. spread of opinions and hate-speech)', 'Public sentiment (e.g. environment-related concerns)', 'News consumption (e.g. sharing of misinformation)', 'Social networks']",2,1,4,"Typically, getting ethical approval means running things through an Institutional Review Board (IRB), outlining methods, how data will be used, and how consent will be obtained. They typically must justify why they are collecting the data they're interested in, and how they will ensure that participants will know their risks and benefits and provide informed consent. Most researchers also must complete individual ethics training, for example through CITI.",Somewhat unacceptable,"this is getting more into public posting, which i find slightly more acceptable than sending a directed private message, but it is still problematic due to not obtaining informed consent or providing a debriefing to participants any time there's a situation of ""didn't know they were in an experiment"" gets my ears burning and flashbacks of my citi training because it is public posts being measured though, it gets much closer to observational research i still don't like that it's tied to individual names though, so not quite acceptable","if it were a fully deidentified platform with random usernames and no real names associated, it would get into a much more acceptable zone for me, in the context of observational research",Completely unacceptable,"there was no informed consent obtained for this the participants were not aware they were in a research study it also says nothing of being debriefed observational research can fall in a gray area, but it has to be fully anonymous (for example, just counting the number of people who walk across a street in a day would be fine since it doesn't identify individuals at all) if there is any kind of interaction, for example by a confederate or the researcher, the researcher needs to provide debriefing after the fact in this case, there is a name attached to the data (even if later deidentified) and no consent obtained, nor any debriefing","not really - they didn't debrief, provide informed consent, or deidentify data this should have failed at the irb",Somewhat acceptable,"this sounds like something that went through an irb rather than targeting specific users, they allowed people to come to them through an advertisement they used informed consent procedures and allowed participants to make decisions the browser extension was optional i will say the only thing i find questionable here is the payment amount $5 for 8 weeks of data is shameful to me people need to be paid based on the value of their labor, time, risk, etc, and that amount fails to do so also i really hate the idea that they could essentially pay to see the results (ie, either get paid or know the study results) that is never okay aggregated results must always be available for those who participate and request them","i would want to know how invasive the browser software was and on average how much time was spent by each user on average using their social media that would adjust the acceptable rate of pay for me (eg, if they are only using it 5-10 minutes a week, it would be more of a reasonable rate)",Somewhat unacceptable,"this is observational research done in a fairly public way, so again, i am mostly okay with this, even without informed consent i still think there needs to be debriefing after the observational period as well as a better way of deidentifying the data","if there was secretly a debriefing done and a good way of ensuring that the data was never paired with the user's real name (i think this might be unavoidable though on a platform like twitter), then it would be more ethically acceptable",Slightly important,Not at all important,Not at all important,Very important,Not at all important,Moderately important,Extremely important,Moderately important,Extremely important,"protection of identity is a big one, as well as providing informed consent i know that is somewhat reflected above, but informed consent is more than just knowing you're being studied, it is opting in with a free choice it is a higher standard to follow ethically",7.0,1.0,6.0,5.0,3.0,4.0,2.0,,,,,,
132,True,845.0,Facebook,47.0,Male,White / Caucasian,Highschool,Very conservative,Very aware,['None of the above'],"['Creating fake accounts (""bots"")']",['Public sentiment (e.g. environment-related concerns)'],0,1,1,they say its ok,Somewhat acceptable,,,Somewhat acceptable,,,Completely acceptable,,,Neutral,,,Moderately important,Slightly important,Very important,Moderately important,Slightly important,Very important,Very important,Very important,Not at all important,None,7.0,6.0,5.0,2.0,1.0,4.0,3.0,None,1.0,,2.0,None,3.0
133,True,1249.0,Facebook,40.0,Male,White / Caucasian,Bachelor's degree,Very liberal,Very aware,"['… are large and can contain millions of data points', '… reflect events in real-time and can be collected continuously over time', '… are readily accessible to researchers and easy to collect']",['None of the above'],"['Political elections (e.g. voting behavior)', 'Economic forecasting', 'Presidential approval ratings', 'Health topics (e.g. spread of diseases)', 'Well-being and economic satisfaction', 'Communication (e.g. spread of opinions and hate-speech)', 'Public sentiment (e.g. environment-related concerns)', 'News consumption (e.g. sharing of misinformation)', 'Social networks']",1,0,9,Its an approval in which both the researchers and the participants are respected ,Somewhat unacceptable,the participants were unaware they were in a research study,,Somewhat unacceptable,participants were not aware they were in a research study,None,Somewhat acceptable,i dont have any concerns except maybe the researchers have too much access to their social media information,,Somewhat unacceptable,the participants were not aware they were in a research study,,Extremely important,Extremely important,Extremely important,Very important,Very important,Moderately important,Extremely important,Very important,Extremely important,,1.0,2.0,6.0,3.0,7.0,4.0,5.0,,,,,,
134,True,702.0,Facebook,66.0,Male,White / Caucasian,Highschool,Slightly conservative,Slightly aware,['… often capture social relationships not found using traditional methods (e.g. surveys)'],"[""Publicly posting on users' profiles""]","['Political elections (e.g. voting behavior)', 'Social networks']",1,1,2,Just guessing but I'll say that researchers must abide by rules established by their institution so they remain ethical in content. ,Completely acceptable,,,Completely acceptable,,,Somewhat acceptable,,,Completely acceptable,,,Very important,Very important,Extremely important,Slightly important,Moderately important,Moderately important,Moderately important,Moderately important,Very important,,7.0,2.0,6.0,5.0,1.0,4.0,3.0,,8.0,,9.0,,10.0
135,True,676.0,Facebook,76.0,Male,White / Caucasian,Bachelor's degree,Slightly liberal,Slightly aware,"['… are large and can contain millions of data points', '… reflect events in real-time and can be collected continuously over time', '… are naturalistic in that they do not require researchers to directly interact with research volunteers', '… often capture social relationships not found using traditional methods (e.g. surveys)']","['Privately messaging users', ""Publicly posting on users' profiles""]","['Political elections (e.g. voting behavior)', 'Economic forecasting', 'Presidential approval ratings', 'Health topics (e.g. spread of diseases)', 'Well-being and economic satisfaction', 'Communication (e.g. spread of opinions and hate-speech)', 'Public sentiment (e.g. environment-related concerns)', 'News consumption (e.g. sharing of misinformation)', 'Social networks']",4,2,9,this might be approval directly from the user in an ethical form like permission,Completely unacceptable,it is not acceptable to gather such info without permission,,Somewhat unacceptable,,,Completely acceptable,,,Somewhat unacceptable,,,Not at all important,Not at all important,Not at all important,Not at all important,Moderately important,Slightly important,Very important,Moderately important,Slightly important,,7.0,1.0,5.0,3.0,4.0,6.0,2.0,,,,,,
136,True,1017.0,Facebook,66.0,Male,White / Caucasian,Bachelor's degree,Very liberal,Not at all aware,"['… reflect events in real-time and can be collected continuously over time', '… are naturalistic in that they do not require researchers to directly interact with research volunteers', '… often capture social relationships not found using traditional methods (e.g. surveys)', '… are readily accessible to researchers and easy to collect']","['Privately messaging users', 'Creating fake accounts (""bots"")', 'Secretly changing the content of what users see']","['Political elections (e.g. voting behavior)', 'Presidential approval ratings', 'Health topics (e.g. spread of diseases)', 'Well-being and economic satisfaction', 'Public sentiment (e.g. environment-related concerns)', 'News consumption (e.g. sharing of misinformation)', 'Social networks']",2,1,7,"I think ethical approval means that they can't alter the postings of people, use hate speech or suggest illegal acts. Also, they have to identify who they are really and not misrepresent themselves and create false identities.",Somewhat acceptable,"again, annonymous accounts but now that i've had more timme to think about it, i don't mind researchers using these type of accounts",,Somewhat acceptable,not sure i like them creating annoymous accounts i guess ok as long as they didn't make up a name,,Completely unacceptable,"they accessed people's internet activity — granted with their consent — without fully disclosing what they were doing also, i consider doing or participating in surveys as work, and as such should be paid for by researchers under current federal minimum wage laws $5 for weeks?",,Somewhat acceptable,"the ""automated, human-looking accounts"" were just suggesting it might not be true and providing a link to check i don't have a problem with this it's not influencing people without iding the researcher",,Very important,Not at all important,Moderately important,Slightly important,Not at all important,Moderately important,Extremely important,Not at all important,Extremely important,,7.0,1.0,3.0,2.0,5.0,6.0,4.0,research details and report filed with the university and part of the public record made available to anyone who asks for it,5.0,,,,
137,True,425.0,Reddit,23.0,Male,White / Caucasian,Highschool,Slightly liberal,Very aware,['… are readily accessible to researchers and easy to collect'],['Privately messaging users'],"['Political elections (e.g. voting behavior)', 'Economic forecasting', 'Presidential approval ratings', 'Health topics (e.g. spread of diseases)', 'Well-being and economic satisfaction', 'Communication (e.g. spread of opinions and hate-speech)', 'Public sentiment (e.g. environment-related concerns)', 'News consumption (e.g. sharing of misinformation)', 'Social networks']",-1,1,9,to avoid tricking people ,Completely acceptable,,,Somewhat unacceptable,,,Neutral,,,Neutral,,,Moderately important,Slightly important,Very important,Not at all important,Moderately important,Moderately important,Very important,Moderately important,Moderately important,,6.0,7.0,5.0,1.0,2.0,3.0,4.0,,,,,,
138,True,764.0,Facebook,49.0,Female,White / Caucasian,Bachelor's degree,Very conservative,Slightly aware,['… often capture social relationships not found using traditional methods (e.g. surveys)'],"['Creating fake accounts (""bots"")', 'Secretly changing the content of what users see']","['Political elections (e.g. voting behavior)', 'Well-being and economic satisfaction', 'Social networks']",1,0,3,"Using proper, ethical methods in the research.",Somewhat acceptable,,,Neutral,,,Somewhat acceptable,,,Somewhat unacceptable,,,Moderately important,Slightly important,Moderately important,Not at all important,Moderately important,Moderately important,Very important,Moderately important,Slightly important,,6.0,7.0,3.0,1.0,2.0,5.0,4.0,,,,,,
139,True,910.0,Facebook,33.0,Male,White / Caucasian,Bachelor's degree,Slightly conservative,Very aware,"['… are large and can contain millions of data points', '… reflect events in real-time and can be collected continuously over time', '… are naturalistic in that they do not require researchers to directly interact with research volunteers', '… often capture social relationships not found using traditional methods (e.g. surveys)', '… are readily accessible to researchers and easy to collect']","['Creating fake accounts (""bots"")', 'Secretly changing the content of what users see']","['Political elections (e.g. voting behavior)', 'Health topics (e.g. spread of diseases)', 'Well-being and economic satisfaction', 'Communication (e.g. spread of opinions and hate-speech)', 'Public sentiment (e.g. environment-related concerns)', 'News consumption (e.g. sharing of misinformation)', 'Social networks']",3,0,7,The institution must find that the nature of the research itself as well as it is proposed to be carried out is ethically sound.,Completely acceptable,,,Completely acceptable,,,Completely unacceptable,,,Completely unacceptable,,,Slightly important,Slightly important,Moderately important,Slightly important,Extremely important,Extremely important,Slightly important,Slightly important,Slightly important,,7.0,4.0,3.0,2.0,5.0,6.0,1.0,,,,,,
140,True,686.0,Facebook,45.0,Female,White / Caucasian,Some college,Slightly conservative,Moderately aware,['None of the above'],"['Privately messaging users', 'Creating fake accounts (""bots"")', 'Secretly changing the content of what users see']",['Public sentiment (e.g. environment-related concerns)'],0,1,1,people have the right to know who knows whos has their data,Somewhat acceptable,,,Neutral,,,Completely unacceptable,,,Somewhat unacceptable,,,Very important,Moderately important,Moderately important,Moderately important,Very important,Moderately important,Moderately important,Moderately important,Moderately important,,1.0,3.0,2.0,6.0,7.0,5.0,4.0,None,3.0,,1.0,,2.0
141,True,1327.0,Reddit,53.0,Male,White / Caucasian,Master's degree or above,Very liberal,Moderately aware,"['… are large and can contain millions of data points', '… reflect events in real-time and can be collected continuously over time', '… often capture social relationships not found using traditional methods (e.g. surveys)', '… are readily accessible to researchers and easy to collect']","[""Publicly posting on users' profiles"", 'Creating fake accounts (""bots"")', 'Secretly changing the content of what users see']","['Political elections (e.g. voting behavior)', 'Economic forecasting', 'Presidential approval ratings', 'Health topics (e.g. spread of diseases)', 'Well-being and economic satisfaction', 'Communication (e.g. spread of opinions and hate-speech)', 'Public sentiment (e.g. environment-related concerns)', 'News consumption (e.g. sharing of misinformation)', 'Social networks']",2,1,9,A board allows a study to proceed under the auspices of an institution because the design of the study does not violate standards of researcher behavior regarding treatment of subjects,Completely acceptable,the researchers presumably did not represent that they were someone else since the accounts were anonymous,,Somewhat acceptable,"direct messaging could be a little misleading, especially since subjects were not aware this was part of a study",,Somewhat acceptable,user liking a page could skew the algorithm so other people might see this potentially polarizing content more often,,Somewhat unacceptable,the appearance that the replies can from individuals who don't exist is worrisome,,Very important,Not at all important,Slightly important,Not at all important,Very important,Moderately important,Moderately important,Slightly important,Not at all important,,7.0,6.0,5.0,4.0,1.0,3.0,2.0,,,,,,
142,True,521.0,Twitter,22.0,Male,Asian - Eastern,Highschool,Very liberal,Moderately aware,"['… are large and can contain millions of data points', '… reflect events in real-time and can be collected continuously over time', '… are naturalistic in that they do not require researchers to directly interact with research volunteers', '… often capture social relationships not found using traditional methods (e.g. surveys)', '… are readily accessible to researchers and easy to collect']","['Privately messaging users', ""Publicly posting on users' profiles""]","['Political elections (e.g. voting behavior)', 'Economic forecasting', 'Presidential approval ratings', 'Health topics (e.g. spread of diseases)', 'Well-being and economic satisfaction', 'Communication (e.g. spread of opinions and hate-speech)', 'Public sentiment (e.g. environment-related concerns)', 'News consumption (e.g. sharing of misinformation)', 'Social networks']",3,2,9,"The institution needs to see that they're not breaking any privacy rules when collecting data in tweets, which more often than not contain sensitive information.",Completely acceptable,,,Somewhat acceptable,,,Completely acceptable,"this is a cooperative effort unlike the rest, so this seems to be the most ethical so far by normal standards",,Neutral,,,Moderately important,Moderately important,Extremely important,Extremely important,Extremely important,Moderately important,Very important,Very important,Extremely important,,7.0,2.0,5.0,1.0,4.0,6.0,3.0,,,,,,
143,True,634.0,Twitter,67.0,Male,White / Caucasian,Master's degree or above,Slightly conservative,Extremely aware,"['… are large and can contain millions of data points', '… reflect events in real-time and can be collected continuously over time', '… are naturalistic in that they do not require researchers to directly interact with research volunteers', '… often capture social relationships not found using traditional methods (e.g. surveys)']","['Privately messaging users', ""Publicly posting on users' profiles"", 'Creating fake accounts (""bots"")']","['Economic forecasting', 'Health topics (e.g. spread of diseases)', 'Well-being and economic satisfaction', 'Communication (e.g. spread of opinions and hate-speech)', 'Public sentiment (e.g. environment-related concerns)', 'News consumption (e.g. sharing of misinformation)', 'Social networks']",4,3,7,They won't get in trouble for it.,Completely unacceptable,researchers should not anonymously interact with study subjects,,Completely unacceptable,people need to know that they have been influenced,,Somewhat acceptable,,,Completely unacceptable,researchers should not anonymously interact with subjects who do not know they are being studied,,Not at all important,Not at all important,Not at all important,Not at all important,Not at all important,Slightly important,Extremely important,Not at all important,Not at all important,,7.0,3.0,6.0,4.0,1.0,5.0,2.0,,,,,,
144,True,1560.0,Reddit,28.0,Female,White / Caucasian,Highschool,Very liberal,Slightly aware,"['… are large and can contain millions of data points', '… reflect events in real-time and can be collected continuously over time', '… are readily accessible to researchers and easy to collect']","['Privately messaging users', ""Publicly posting on users' profiles"", 'Creating fake accounts (""bots"")']","['Political elections (e.g. voting behavior)', 'Communication (e.g. spread of opinions and hate-speech)', 'Public sentiment (e.g. environment-related concerns)', 'News consumption (e.g. sharing of misinformation)']",1,3,4,It means that the experiment would not in any way cause harm to the unknowing participants?,Completely acceptable,"the experiment did not cause any harm to the unknowing participants, and also influenced their behavior in a positive way i think it was completely acceptable",,Completely acceptable,"i think this was an interesting study, and completely harmless to the participants it  was also beneficial to both the researchers and the participants themselves, as it improved the quality of the news content they shared",,Completely acceptable,the participants were informed that they were taking part in a research study and knew what they were signing up for this is especially important when it involves tracking their browsing activity with a browser extension i think it was completely acceptable and also interesting to see how their behavior changed over the course of the experiment,,Completely acceptable,"i think it's interesting to see how the participants respond to the experiments and is very eye-opening to behavior on social media i think the experiment was completely ethical and harmless, as well as really interesting",,Not at all important,Not at all important,Not at all important,Not at all important,Not at all important,Slightly important,Not at all important,Not at all important,Not at all important,"as long as the research being conducted will not harm the participants, i don't have any levels of concern",5.0,6.0,7.0,2.0,1.0,4.0,3.0,,,,,,
145,True,2825.0,Facebook,65.0,Female,White / Caucasian,Highschool,Very liberal,Moderately aware,"['… are large and can contain millions of data points', '… reflect events in real-time and can be collected continuously over time', '… are readily accessible to researchers and easy to collect']","['Creating fake accounts (""bots"")']","['Political elections (e.g. voting behavior)', 'Economic forecasting', 'Presidential approval ratings', 'Health topics (e.g. spread of diseases)', 'Well-being and economic satisfaction', 'Communication (e.g. spread of opinions and hate-speech)', 'Public sentiment (e.g. environment-related concerns)', 'News consumption (e.g. sharing of misinformation)', 'Social networks']",1,1,9,"I would say that they would have to ask your permission to use your information. They would have to say that their information would not be used or if they are they would have to let them know. Also, they would have to let the participants know if this is an opinion. ",Somewhat acceptable,seems like they read where they were not facts the goal is to not spread false information if we can find a way to weed out the false information then it is worth it,,Somewhat unacceptable,"the fact that these were not factual and that they shared them with their friends, were spread the lies or non-truths even more","i think the way you get your data is kinda ok, but the fact that it included false information, that concerns me we should be working at getting out the facts and have people rely on facts and not lies",Somewhat acceptable,sounds like the goal was met  i think to see that people are still researching for truths,seems like it would be a study that i would participate them,Somewhat unacceptable,"i know getting the information is important, but with the partisan going on right now, it is just dividing us we need to find other ways to get information without false information that will divide our country",do not use false information maybe put highlight a few times to say this is not true,Extremely important,Moderately important,Extremely important,Very important,Very important,Moderately important,Very important,Extremely important,Very important,"as i read all the different ways, it seems like if the data is completely safe from others and the goal is to get people to stop the spread of misinformation, seems like it is worth it",7.0,2.0,4.0,1.0,5.0,6.0,3.0,make sure that they will know that this is misinformation,1.0,privacy that their identity will not be known,2.0,collection of data that is personal,6.0
146,True,378.0,Twitter,28.0,Male,White / Caucasian,Bachelor's degree,Very liberal,Very aware,['… often capture social relationships not found using traditional methods (e.g. surveys)'],"['Creating fake accounts (""bots"")']",['Public sentiment (e.g. environment-related concerns)'],1,1,1,Ethical approval is getting approval to determine if actions are ethical. ,Somewhat acceptable,,,Neutral,,,Somewhat acceptable,,,Neutral,,,Moderately important,Moderately important,Moderately important,Very important,Moderately important,Very important,Very important,Moderately important,Moderately important,,1.0,6.0,5.0,3.0,2.0,7.0,4.0,,,,,,
147,True,1464.0,Reddit,24.0,Male,White / Caucasian,Bachelor's degree,Slightly liberal,Moderately aware,"['… are large and can contain millions of data points', '… reflect events in real-time and can be collected continuously over time', '… are naturalistic in that they do not require researchers to directly interact with research volunteers', '… often capture social relationships not found using traditional methods (e.g. surveys)', '… are readily accessible to researchers and easy to collect']","['Privately messaging users', ""Publicly posting on users' profiles"", 'Creating fake accounts (""bots"")']","['Political elections (e.g. voting behavior)', 'Economic forecasting', 'Presidential approval ratings', 'Health topics (e.g. spread of diseases)', 'Well-being and economic satisfaction', 'Communication (e.g. spread of opinions and hate-speech)', 'Public sentiment (e.g. environment-related concerns)', 'News consumption (e.g. sharing of misinformation)', 'Social networks']",3,3,9,"Ethical approval means that how ever they're interacting with people, it won't harm them and won't be a violation on how the data is utilized. ",Completely acceptable,,if data became unprotectedpublic on users,Completely acceptable,,if the data became not anonymous,Completely acceptable,,,Somewhat acceptable,the study is somewhat geared at triggering people,if data about users is made public,Very important,Extremely important,Very important,Very important,Moderately important,Extremely important,Slightly important,Very important,Very important,,7.0,5.0,2.0,3.0,1.0,6.0,4.0,,,,,,
148,True,502.0,Facebook,40.0,Male,White / Caucasian,Bachelor's degree,Slightly conservative,Moderately aware,"['… are large and can contain millions of data points', '… reflect events in real-time and can be collected continuously over time', '… are naturalistic in that they do not require researchers to directly interact with research volunteers', '… are readily accessible to researchers and easy to collect']","[""Publicly posting on users' profiles"", 'Creating fake accounts (""bots"")', 'Secretly changing the content of what users see']","['Political elections (e.g. voting behavior)', 'Economic forecasting', 'Presidential approval ratings', 'Health topics (e.g. spread of diseases)', 'Well-being and economic satisfaction', 'Communication (e.g. spread of opinions and hate-speech)', 'Public sentiment (e.g. environment-related concerns)', 'News consumption (e.g. sharing of misinformation)', 'Social networks']",2,1,9,They need to make the institution aware of how they are performing their work.  They must get approval that it meets within the institution guidelines,Completely acceptable,i do not see any issues with this,as long as researches didnt promotr hate speech then no,Somewhat acceptable,as long as researchers werent promoting anything hateful or offensive,,Completely acceptable,the study may be skewed by people not being real in their actions,,Completely acceptable,they were not posting anything fake or offensive,,Very important,Slightly important,Not at all important,Not at all important,Slightly important,Moderately important,Slightly important,Moderately important,Very important,,7.0,5.0,1.0,6.0,2.0,4.0,3.0,,,,,,
149,True,1015.0,Twitter,47.0,Male,White / Caucasian,Highschool,Slightly liberal,Slightly aware,"['… are large and can contain millions of data points', '… reflect events in real-time and can be collected continuously over time', '… are naturalistic in that they do not require researchers to directly interact with research volunteers', '… often capture social relationships not found using traditional methods (e.g. surveys)', '… are readily accessible to researchers and easy to collect']","['Creating fake accounts (""bots"")']","['Political elections (e.g. voting behavior)', 'Presidential approval ratings', 'Health topics (e.g. spread of diseases)', 'Communication (e.g. spread of opinions and hate-speech)', 'News consumption (e.g. sharing of misinformation)', 'Social networks']",3,1,6,I believe it means to have approval that is to be done in a way that would not compromise someone's character or that of the institution.,Neutral,i am really undecided about this there was an unawareness of the study but it did help in a really toxic situation,,Completely acceptable,i think that is a fine study to do and is kept within an ethical stand point,,Completely acceptable,i find this study to be acceptable because of the awareness,,Completely unacceptable,this is in a line of definitely not being acceptable because of the unawareness of the study!,,Very important,Extremely important,Very important,Extremely important,Extremely important,Moderately important,Extremely important,Extremely important,Extremely important,i just believe people should be aware some what of the research i know that can influence some data and how people would normally react if they thought they were not being watched or monitored so it is a risk of having data not be accurate,7.0,1.0,5.0,3.0,6.0,4.0,2.0,anonymous behavior and accounts interacting with unknown participants,2.0,,8.0,,
150,True,1842.0,Reddit,35.0,Female,Mixed race,Bachelor's degree,Neutral/ Neither conservative or liberal,Not at all aware,['… are readily accessible to researchers and easy to collect'],"['Privately messaging users', 'Creating fake accounts (""bots"")', 'Secretly changing the content of what users see']","['Political elections (e.g. voting behavior)', 'Presidential approval ratings', 'Communication (e.g. spread of opinions and hate-speech)', 'Public sentiment (e.g. environment-related concerns)', 'Social networks']",-1,1,5,"I would think that this means they need to get a ""This meets ethical standards. You can do ""XYZ"" to the general public, without it crossing a line. Or how, when, and where they conduct it."" kind of experiment sign-off from their academic institution.",Neutral,"i'm on the fence about this it's not too intrusive, and yes it was deceptive, it relayed neutral information i just don't like the idea of users not being aware, that a research study is being conducted",,Completely unacceptable,"unacceptable this research should be deemed invalid because the messages were unsolicited they were sent out randomly, and those who participated were unaware of the research i think it's really important for someone to consent, and to make sure everyone involved is aware that research is being conducted it's possible to conduct a study, without having to send unsolicited messages, with false intentions to people","i have another issue with this those on both the left and right-leaning aisle are guilty of spreading misinformation i think it's disingenuous for the researchers to target only right-leaning users target both the far left and the far right, the dead center, and then come to me with your results",Somewhat acceptable,"i don't find anything wrong with this ther users consented to have specific data monitored, and it was used for specific research purposes","the only way i would find this unethical is if the software monitored other user activity, outside of what was consented upon",Somewhat acceptable,"i find this slightly acceptable because everything was conducted out in the open, in public no one was dm'd privately with unsolicited links","it sounds like the description of the research summary conducted; both political aisles were targeted and not just one i find this to be more neutral, and not biased toward one side of the other",Very important,Slightly important,Extremely important,Slightly important,Very important,Extremely important,Moderately important,Slightly important,Moderately important,a lot of things are concerning when dealing with datastudy research on social media is it reliable data? are the researchers reliable? what is the intention of the study? is the social media platform itself a reliable place to even conduct research on?,5.0,2.0,7.0,4.0,1.0,6.0,3.0,"the study conducted, and the data collected should remain unbiased, and neutral of a researcher's own feelings toward the data presented",1.0,,0.0,,0.0
151,True,1270.0,Reddit,35.0,Male,Asian - Southeast,Some college,Very conservative,Moderately aware,"['… are large and can contain millions of data points', '… are naturalistic in that they do not require researchers to directly interact with research volunteers', '… often capture social relationships not found using traditional methods (e.g. surveys)', '… are readily accessible to researchers and easy to collect']","[""Publicly posting on users' profiles"", 'Creating fake accounts (""bots"")', 'Secretly changing the content of what users see']","['Political elections (e.g. voting behavior)', 'Communication (e.g. spread of opinions and hate-speech)', 'Public sentiment (e.g. environment-related concerns)', 'News consumption (e.g. sharing of misinformation)', 'Social networks']",2,1,5,'Ethical approval' is probably whether or not the methods used in the experiment are found to be morally acceptable by the institution.,Completely unacceptable,"i despite any sort of coordinated ""attack"" against people who are unaware they're being manipulated by those with an agenda either be up-front with your intentions or properly pay people for a study",,Completely unacceptable,"again, despicable actions by ""academic researchers"" who are trying to manipulate people for their own ends this type of behavior only justifies right-leaning people into distrusting academia",,Completely acceptable,,"as long as the users knew they were being tracked, it looks fine to me",Completely unacceptable,"i strongly dislike the use of ""fake humans"" to try and control others in any meaningful way, even if it's just an experiment it's dishonest and distasteful",,Slightly important,Not at all important,Not at all important,Not at all important,Extremely important,Extremely important,Extremely important,Slightly important,Not at all important,honesty in the study is important - the worst is lying to people and them never being aware of it,4.0,1.0,6.0,3.0,5.0,7.0,2.0,,,,,,
152,True,1244.0,Reddit,36.0,Male,White / Caucasian,Bachelor's degree,Very liberal,Slightly aware,"['… are large and can contain millions of data points', '… reflect events in real-time and can be collected continuously over time', '… are naturalistic in that they do not require researchers to directly interact with research volunteers', '… often capture social relationships not found using traditional methods (e.g. surveys)', '… are readily accessible to researchers and easy to collect']","['Privately messaging users', 'Creating fake accounts (""bots"")', 'Secretly changing the content of what users see']","['Political elections (e.g. voting behavior)', 'Economic forecasting', 'Presidential approval ratings', 'Health topics (e.g. spread of diseases)', 'Well-being and economic satisfaction', 'Communication (e.g. spread of opinions and hate-speech)', 'Public sentiment (e.g. environment-related concerns)', 'News consumption (e.g. sharing of misinformation)']",3,1,8,"Clearly defining and then strictly adhering to standard research norms in order to preserve dignity, minimize risk and only using deception when necessary and fully debriefing survey participants afterward.",Somewhat unacceptable,"while i can understand the need for deception (so that the twitter users posting hate speech accurately respond to what they believe are 'real' people), i think that there should have been more safeguards in place","i would have found it more ethically acceptable if there was any information about post-study debriefing, if any",Somewhat unacceptable,"although i inwardly cheer this sort of study because of its importance, i think the unsolicited nature of unwitting participants is worrisome","again, more debriefing information post study would be good to know (also, results?)",Completely acceptable,,,Somewhat acceptable,"i think this is a pretty important subject, so i'm glad they are trying to address this issue",,Moderately important,Extremely important,Moderately important,Extremely important,Moderately important,Very important,Moderately important,Extremely important,Very important,"debriefing, properly disclosing pertinent information, and rationalizing deception",7.0,6.0,5.0,2.0,1.0,4.0,3.0,attempt to properly compensate those involved,8.0,promise to furnish debriefing post survey,9.0,promise to offer access to study results ifwhen available,10.0
153,True,550.0,Facebook,29.0,Male,White / Caucasian,Bachelor's degree,Slightly liberal,Moderately aware,"['… are large and can contain millions of data points', '… are readily accessible to researchers and easy to collect']",['Privately messaging users'],"['Health topics (e.g. spread of diseases)', 'Public sentiment (e.g. environment-related concerns)', 'News consumption (e.g. sharing of misinformation)', 'Social networks']",0,1,4,It means that the research will do no harm to the participants.,Somewhat acceptable,,,Somewhat acceptable,,,Completely acceptable,,,Completely acceptable,,,Extremely important,Moderately important,Moderately important,Very important,Moderately important,Very important,Extremely important,Moderately important,Very important,,4.0,6.0,7.0,2.0,1.0,5.0,3.0,,,,,,
154,True,1708.0,Facebook,38.0,Female,White / Caucasian,Master's degree or above,Slightly conservative,Extremely aware,"['… are large and can contain millions of data points', '… reflect events in real-time and can be collected continuously over time', '… are naturalistic in that they do not require researchers to directly interact with research volunteers', '… often capture social relationships not found using traditional methods (e.g. surveys)', '… are readily accessible to researchers and easy to collect']","['Privately messaging users', ""Publicly posting on users' profiles"", 'Creating fake accounts (""bots"")', 'Secretly changing the content of what users see']","['Political elections (e.g. voting behavior)', 'Economic forecasting', 'Presidential approval ratings', 'Health topics (e.g. spread of diseases)', 'Well-being and economic satisfaction', 'Communication (e.g. spread of opinions and hate-speech)', 'Public sentiment (e.g. environment-related concerns)', 'News consumption (e.g. sharing of misinformation)', 'Social networks']",3,2,9,"Ethical approval means that someone reviews the experiment proposal to make sure participants won't be physically or mentally harmed, nor will there be damage to personal property or animals.",Completely acceptable,,,Somewhat unacceptable,the one thing wrong with this study is targeting right-leaning users only left-leaning users also spread misinformation academic research shouldn't favor one party over another,do the same thing with left-leaning users also,Completely acceptable,,,Somewhat unacceptable,it's bad for society overall because it creates more of a division between people,,Moderately important,Extremely important,Extremely important,Moderately important,Extremely important,Extremely important,Moderately important,Not at all important,Moderately important,,6.0,4.0,5.0,1.0,2.0,7.0,3.0,,,,,,
155,True,662.0,Twitter,63.0,Female,White / Caucasian,Bachelor's degree,Very liberal,Moderately aware,"['… are large and can contain millions of data points', '… are naturalistic in that they do not require researchers to directly interact with research volunteers', '… often capture social relationships not found using traditional methods (e.g. surveys)', '… are readily accessible to researchers and easy to collect']","['Privately messaging users', ""Publicly posting on users' profiles"", 'Creating fake accounts (""bots"")']","['Political elections (e.g. voting behavior)', 'Presidential approval ratings', 'Health topics (e.g. spread of diseases)', 'Communication (e.g. spread of opinions and hate-speech)', 'Public sentiment (e.g. environment-related concerns)', 'News consumption (e.g. sharing of misinformation)', 'Social networks']",2,3,7,It mean they have to have ethics with the research.,Somewhat acceptable,,,Somewhat acceptable,,,Somewhat acceptable,,,Somewhat acceptable,,,Moderately important,Moderately important,Moderately important,Slightly important,Slightly important,Moderately important,Slightly important,Very important,Moderately important,,7.0,1.0,5.0,4.0,2.0,3.0,6.0,,,,,,
156,True,200.0,Facebook,19.0,Male,White / Caucasian,Highschool,Very liberal,Very aware,"['… are readily accessible to researchers and easy to collect', '… are always representative of people’s offline behavior', '… are well formatted and never contain any missing data']","['Creating fake accounts (""bots"")', 'Secretly changing the content of what users see']","['Economic forecasting', 'Health topics (e.g. spread of diseases)', 'Communication (e.g. spread of opinions and hate-speech)']",-3,0,3,I think which kind of approval that is legal ,Neutral,,,Somewhat acceptable,,,Completely acceptable,,,Completely acceptable,,,Moderately important,Extremely important,Very important,Very important,Moderately important,Moderately important,Extremely important,Very important,Moderately important,,5.0,3.0,6.0,7.0,1.0,4.0,2.0,,,,,,
157,True,1394.0,Reddit,45.0,Male,White / Caucasian,Highschool,Neutral/ Neither conservative or liberal,Very aware,"['… are large and can contain millions of data points', '… reflect events in real-time and can be collected continuously over time', '… are naturalistic in that they do not require researchers to directly interact with research volunteers', '… often capture social relationships not found using traditional methods (e.g. surveys)', '… are readily accessible to researchers and easy to collect']","['Privately messaging users', ""Publicly posting on users' profiles"", 'Creating fake accounts (""bots"")', 'Secretly changing the content of what users see']","['Political elections (e.g. voting behavior)', 'Economic forecasting', 'Presidential approval ratings', 'Health topics (e.g. spread of diseases)', 'Well-being and economic satisfaction', 'Communication (e.g. spread of opinions and hate-speech)', 'Public sentiment (e.g. environment-related concerns)', 'News consumption (e.g. sharing of misinformation)', 'Social networks']",3,2,9,Ethical approval means that the data will be used in a manner not harmful to the participants of the study.,Completely acceptable,this experiment showed that hate speech can be lessened so therefore it is very ethical,,Somewhat acceptable,the user was not harmedthey were made more aware and then shared higher quality content afterwards,,Somewhat unacceptable,the browser extension is an invasion of privacy because it is being installed under false pretenses,,Somewhat acceptable,i think that the posters were not harmed but were made aware of new information that could be used to more accurately tweet,,Moderately important,Slightly important,Moderately important,Slightly important,Moderately important,Moderately important,Very important,Very important,Moderately important,whether or not privacy is invaded,3.0,6.0,4.0,1.0,2.0,7.0,5.0,,,,,,
158,True,329.0,Twitter,45.0,Male,White / Caucasian,Bachelor's degree,Neutral/ Neither conservative or liberal,Not at all aware,"['… are large and can contain millions of data points', '… often capture social relationships not found using traditional methods (e.g. surveys)', '… are readily accessible to researchers and easy to collect', '… are always representative of people’s offline behavior', '… are unaffected by the way social media platforms work']","['Privately messaging users', ""Publicly posting on users' profiles"", 'Creating fake accounts (""bots"")', 'Secretly changing the content of what users see']","['Political elections (e.g. voting behavior)', 'Presidential approval ratings', 'Health topics (e.g. spread of diseases)', 'Communication (e.g. spread of opinions and hate-speech)', 'Public sentiment (e.g. environment-related concerns)', 'News consumption (e.g. sharing of misinformation)']",-1,2,6,It means getting approval by being open and honest about what they are doing.  It is being truthful. ,Completely acceptable,"this is a fair, good way to get truthful data",,Somewhat acceptable,sometimes you have to do things like this to get data no one was hurt by this so it is fine,,Completely acceptable,this is a very smart way to get data for their research,,Somewhat acceptable,"i think this is a smart, legitimate way to get reliable data",,Moderately important,Very important,Extremely important,Moderately important,Extremely important,Moderately important,Very important,Very important,Moderately important,,5.0,3.0,4.0,6.0,1.0,7.0,2.0,,,,,,
159,True,725.0,Facebook,49.0,Male,White / Caucasian,Highschool,Neutral/ Neither conservative or liberal,Moderately aware,"['… are large and can contain millions of data points', '… reflect events in real-time and can be collected continuously over time', '… are naturalistic in that they do not require researchers to directly interact with research volunteers', '… are readily accessible to researchers and easy to collect']","['Creating fake accounts (""bots"")']","['Political elections (e.g. voting behavior)', 'Economic forecasting', 'Presidential approval ratings', 'Health topics (e.g. spread of diseases)', 'Well-being and economic satisfaction', 'Communication (e.g. spread of opinions and hate-speech)', 'Public sentiment (e.g. environment-related concerns)', 'News consumption (e.g. sharing of misinformation)', 'Social networks']",2,1,9,research involving potentially vulnerable groups,Neutral,no concerns i think anyone who regularly reports hate speech should be monitored,,Somewhat unacceptable,due to the fact they were not aware,,Completely acceptable,acceptable everyone knows what's going on,,Somewhat acceptable,,,Slightly important,Moderately important,Slightly important,Slightly important,Slightly important,Slightly important,Moderately important,Slightly important,Slightly important,,7.0,4.0,3.0,1.0,2.0,6.0,5.0,None,8.0,,9.0,,10.0
160,True,817.0,Twitter,24.0,Male,White / Caucasian,Bachelor's degree,Very liberal,Very aware,"['… are large and can contain millions of data points', '… reflect events in real-time and can be collected continuously over time', '… are naturalistic in that they do not require researchers to directly interact with research volunteers', '… often capture social relationships not found using traditional methods (e.g. surveys)', '… are readily accessible to researchers and easy to collect']","['Privately messaging users', ""Publicly posting on users' profiles"", 'Creating fake accounts (""bots"")', 'Secretly changing the content of what users see']","['Political elections (e.g. voting behavior)', 'Economic forecasting', 'Presidential approval ratings', 'Health topics (e.g. spread of diseases)', 'Well-being and economic satisfaction', 'Communication (e.g. spread of opinions and hate-speech)', 'Public sentiment (e.g. environment-related concerns)', 'News consumption (e.g. sharing of misinformation)', 'Social networks']",3,2,9,"Their institution has to review the experiment and make sure it doesn't take advantage of the participants without informed consent. I assume the experiment shouldn't cause any excessive physical, emotional, or mental anguish to participants without them being aware of the possibility. ",Completely acceptable,,,Completely acceptable,,,Somewhat acceptable,,,Completely acceptable,,,Not at all important,Not at all important,Not at all important,Not at all important,Extremely important,Extremely important,Moderately important,Not at all important,Not at all important,awareness is definitely a big one,5.0,1.0,7.0,3.0,2.0,4.0,6.0,,,,,,
161,True,525.0,Facebook,35.0,Female,White / Caucasian,Bachelor's degree,Slightly liberal,Slightly aware,"['… are large and can contain millions of data points', '… reflect events in real-time and can be collected continuously over time', '… are naturalistic in that they do not require researchers to directly interact with research volunteers', '… are readily accessible to researchers and easy to collect']","['Privately messaging users', ""Publicly posting on users' profiles"", 'Creating fake accounts (""bots"")']","['Political elections (e.g. voting behavior)', 'Economic forecasting', 'Presidential approval ratings', 'Health topics (e.g. spread of diseases)', 'Well-being and economic satisfaction', 'Communication (e.g. spread of opinions and hate-speech)', 'Public sentiment (e.g. environment-related concerns)', 'News consumption (e.g. sharing of misinformation)', 'Social networks']",2,3,9,Informed consent from those being researched.,Somewhat unacceptable,,although i like the outcome of this research i still think it is a little unethical to create fake accounts to manipulate people,Somewhat unacceptable,,wasn't it weird for them to receive a random pm?,Completely acceptable,"people were informed, so they could make their own decision to participate and were compensated for their time",,Somewhat unacceptable,making fake accounts to manipulate people is sketchy,,Very important,Slightly important,Not at all important,Very important,Slightly important,Very important,Extremely important,Extremely important,Slightly important,,4.0,3.0,6.0,1.0,2.0,5.0,7.0,,,,,,
162,True,578.0,Facebook,35.0,Female,Asian - Eastern,Bachelor's degree,Neutral/ Neither conservative or liberal,Very aware,"['… are large and can contain millions of data points', '… reflect events in real-time and can be collected continuously over time', '… are naturalistic in that they do not require researchers to directly interact with research volunteers', '… often capture social relationships not found using traditional methods (e.g. surveys)', '… are readily accessible to researchers and easy to collect']","['Creating fake accounts (""bots"")', 'Secretly changing the content of what users see']","['Political elections (e.g. voting behavior)', 'Economic forecasting', 'Health topics (e.g. spread of diseases)', 'Well-being and economic satisfaction', 'Communication (e.g. spread of opinions and hate-speech)', 'Public sentiment (e.g. environment-related concerns)', 'News consumption (e.g. sharing of misinformation)']",3,0,7,"Ethics approval is needed for any research that involves human participants; their tissue and /or data to ensure that the dignity, rights, safety and well-being of all participants are the primary consideration of the research project.",Completely unacceptable,,,Somewhat acceptable,,,Somewhat acceptable,,,Somewhat unacceptable,,,Very important,Very important,Very important,Moderately important,Slightly important,Very important,Very important,Very important,Moderately important,,6.0,5.0,3.0,7.0,1.0,2.0,4.0,,,,,,
163,True,794.0,Reddit,32.0,Male,Asian - Eastern,Bachelor's degree,Very liberal,Very aware,"['… are large and can contain millions of data points', '… reflect events in real-time and can be collected continuously over time', '… are readily accessible to researchers and easy to collect']","['Privately messaging users', 'Creating fake accounts (""bots"")']","['Presidential approval ratings', 'Communication (e.g. spread of opinions and hate-speech)', 'Public sentiment (e.g. environment-related concerns)', 'News consumption (e.g. sharing of misinformation)', 'Social networks']",1,2,5,Ethical approval means that the institution has verified that the researcher is respecting the rights and safety of the people being researched. ,Somewhat acceptable,,,Somewhat unacceptable,,,Completely acceptable,,,Somewhat acceptable,,,Very important,Not at all important,Extremely important,Slightly important,Not at all important,Extremely important,Moderately important,Slightly important,Very important,,7.0,5.0,6.0,3.0,1.0,2.0,4.0,,,,,,
164,True,1142.0,Reddit,39.0,Male,White / Caucasian,Bachelor's degree,Very liberal,Extremely aware,"['… are large and can contain millions of data points', '… reflect events in real-time and can be collected continuously over time', '… are readily accessible to researchers and easy to collect']","['Creating fake accounts (""bots"")']","['Political elections (e.g. voting behavior)', 'Health topics (e.g. spread of diseases)', 'Well-being and economic satisfaction', 'Communication (e.g. spread of opinions and hate-speech)', 'Public sentiment (e.g. environment-related concerns)', 'News consumption (e.g. sharing of misinformation)', 'Social networks']",1,1,7,I would assume it means that the study is being done according to industry/general standards. ,Completely acceptable,i cannot see anything that would make this problematic i don't see why they'd need to be notified they are in a research study,,Completely acceptable,"my guess is that at least some of the people who are sharing utterly insane drivel have some sense that it is inaccurate and just reinforcing their political worldview so when they're asked to rate something for accuracy, it probably gets them thinking more about the accuracy of their own posts",,Completely acceptable,"while i would never participate in any study that asked me to install things, everyone can make that decision for themselves",,Completely acceptable,"at first i thought that was incredibly odd, but then i thought about the type of people who are constantly sharing legitimately fake news on social media",,Slightly important,Not at all important,Not at all important,Not at all important,Not at all important,Not at all important,Not at all important,Not at all important,Slightly important,not really i'm generally going to assume that any researcher wants to adhere to ethical standards specifically so her research is considered valid,5.0,4.0,2.0,3.0,1.0,7.0,6.0,,8.0,,,,
165,True,495.0,Facebook,55.0,Male,White / Caucasian,Bachelor's degree,Neutral/ Neither conservative or liberal,Moderately aware,"['… are large and can contain millions of data points', '… are readily accessible to researchers and easy to collect']",['Secretly changing the content of what users see'],"['Political elections (e.g. voting behavior)', 'Presidential approval ratings', 'Well-being and economic satisfaction', 'Communication (e.g. spread of opinions and hate-speech)', 'Public sentiment (e.g. environment-related concerns)']",0,-1,5,The experiment meets standards as established by yada yada yada.,Somewhat unacceptable,,,Completely unacceptable,participants unaware and are being sent unsolicited messages,,Completely acceptable,,i'd never download an extension but they are asking the participant's permission to do so,Somewhat unacceptable,,,Extremely important,Not at all important,Moderately important,Not at all important,Slightly important,Extremely important,Extremely important,Not at all important,Very important,hard to trust researchers in the future if deception is a regularly used practice,6.0,3.0,5.0,1.0,4.0,7.0,2.0,,1.0,,2.0,,3.0
166,True,550.0,Reddit,26.0,Male,Mixed race,Highschool,Very liberal,Very aware,"['… are large and can contain millions of data points', '… reflect events in real-time and can be collected continuously over time', '… are naturalistic in that they do not require researchers to directly interact with research volunteers', '… often capture social relationships not found using traditional methods (e.g. surveys)', '… are readily accessible to researchers and easy to collect']","['Privately messaging users', 'Creating fake accounts (""bots"")', 'Secretly changing the content of what users see']","['Political elections (e.g. voting behavior)', 'Presidential approval ratings', 'Health topics (e.g. spread of diseases)', 'Well-being and economic satisfaction', 'Communication (e.g. spread of opinions and hate-speech)', 'Public sentiment (e.g. environment-related concerns)', 'News consumption (e.g. sharing of misinformation)', 'Social networks']",3,1,8,Whether the experiment is moral.,Completely acceptable,,,Completely acceptable,,,Completely acceptable,,,Completely acceptable,,,Not at all important,Not at all important,Extremely important,Slightly important,Not at all important,Not at all important,Slightly important,Not at all important,Slightly important,nothing that i can think of off the top of my head,7.0,1.0,3.0,5.0,2.0,6.0,4.0,,,,,,
167,True,940.0,Facebook,25.0,Female,White / Caucasian,Highschool,Slightly liberal,Slightly aware,"['… are large and can contain millions of data points', '… reflect events in real-time and can be collected continuously over time', '… are naturalistic in that they do not require researchers to directly interact with research volunteers', '… often capture social relationships not found using traditional methods (e.g. surveys)', '… are readily accessible to researchers and easy to collect']","['Privately messaging users', ""Publicly posting on users' profiles"", 'Creating fake accounts (""bots"")']","['Political elections (e.g. voting behavior)', 'Presidential approval ratings', 'Well-being and economic satisfaction', 'Communication (e.g. spread of opinions and hate-speech)', 'News consumption (e.g. sharing of misinformation)']",3,3,5,ethical approval is approval based on the way in which the study is conducted. the study is above-board and meets the requirements for being moral and safe,Neutral,my only concern is that the replies to the hate speech were different,maybe knowing what the messages were,Somewhat acceptable,,,Completely acceptable,,,Somewhat acceptable,,,Moderately important,Very important,Slightly important,Moderately important,Moderately important,Very important,Very important,Very important,Moderately important,,7.0,4.0,6.0,3.0,1.0,2.0,5.0,there are no additional factors,10.0,there are no additional factors,10.0,there are no additional factors,10.0
168,True,1789.0,Facebook,32.0,Female,White / Caucasian,Master's degree or above,Neutral/ Neither conservative or liberal,Not at all aware,"['… are large and can contain millions of data points', '… reflect events in real-time and can be collected continuously over time', '… are naturalistic in that they do not require researchers to directly interact with research volunteers', '… are readily accessible to researchers and easy to collect']","['Privately messaging users', ""Publicly posting on users' profiles"", 'Creating fake accounts (""bots"")']","['Communication (e.g. spread of opinions and hate-speech)', 'News consumption (e.g. sharing of misinformation)', 'Social networks']",2,3,3,"To make sure that the experiment asks for consent, clearly communicates if participating can be harmful to the participant in any way, and gives a brief description of what the participant should expect. Also to give the opportunity to reach out with any questions or to remove consent at the end of the study if deception was involved.",Somewhat unacceptable,"using public posts aka posts that the participants willingly posted and shared publicly is ok, and the researchers were allowed to comment i still would have told the participants eventually that their data will be used in a study",i would like to know how they identified all the accounts did they use publicly available information?,Completely unacceptable,i think it should have been communicated that the participants were part of a research study to ask for their consent,,Completely acceptable,"participants were informed about the study, participation was voluntary and they even got the chance to be compensated - i think this seems ethical and good practice",,Completely unacceptable,"using bots, not disclosing the study, and making the situation worse by further radicalizing people? not great practices",,Moderately important,Not at all important,Not at all important,Not at all important,Very important,Extremely important,Extremely important,Extremely important,Very important,"information on who is conducting the research study (is it a university, a for-profit company, a political party?) and compensation",6.0,4.0,7.0,3.0,2.0,5.0,1.0,"information on the researcher as some participant may chose not to participate if the research is conducted by certain institutions, companies, or political parties",8.0,,,,
169,True,473.0,Facebook,25.0,Female,White / Caucasian,Bachelor's degree,Slightly conservative,Moderately aware,"['… are large and can contain millions of data points', '… reflect events in real-time and can be collected continuously over time', '… often capture social relationships not found using traditional methods (e.g. surveys)', '… are readily accessible to researchers and easy to collect']","['Privately messaging users', 'Creating fake accounts (""bots"")']","['Political elections (e.g. voting behavior)', 'Health topics (e.g. spread of diseases)', 'Communication (e.g. spread of opinions and hate-speech)', 'Public sentiment (e.g. environment-related concerns)', 'News consumption (e.g. sharing of misinformation)', 'Social networks']",2,2,6,make sure that they are not violating anyone's rights and taking over their account,Somewhat acceptable,what kind of hate speech was it,they should have told them it was part of a study,Neutral,,should have known it was a study,Somewhat acceptable,this is the most interesting study,i like the idea of picking their reward,Somewhat acceptable,it is a way of getting information out there,i appreciate that they told them it was part of a study,Very important,Very important,Slightly important,Very important,Moderately important,Moderately important,Very important,Moderately important,Slightly important,,7.0,1.0,6.0,5.0,4.0,3.0,2.0,,8.0,,9.0,who is involved in the research,10.0
170,True,492.0,Facebook,42.0,Male,White / Caucasian,Associate's degree,Neutral/ Neither conservative or liberal,Extremely aware,"['… are large and can contain millions of data points', '… reflect events in real-time and can be collected continuously over time', '… often capture social relationships not found using traditional methods (e.g. surveys)', '… are readily accessible to researchers and easy to collect']","['Privately messaging users', ""Publicly posting on users' profiles"", 'Creating fake accounts (""bots"")', 'Secretly changing the content of what users see']","['Political elections (e.g. voting behavior)', 'Economic forecasting', 'Presidential approval ratings', 'Health topics (e.g. spread of diseases)', 'Well-being and economic satisfaction', 'Communication (e.g. spread of opinions and hate-speech)', 'Public sentiment (e.g. environment-related concerns)', 'News consumption (e.g. sharing of misinformation)', 'Social networks']",2,2,9,"Ethical approval suggests an approach to gathering data that is appropriate, non-invasive, and protects privacy.",Completely acceptable,,,Somewhat acceptable,directly messaging users seems a little shady,,Completely acceptable,,,Completely acceptable,,,Moderately important,Very important,Extremely important,Not at all important,Slightly important,Not at all important,Slightly important,Not at all important,Very important,i participate in dozens of academic studies each week  i suppose compensation would be of concern,6.0,1.0,4.0,2.0,3.0,5.0,7.0,,,,,,
171,True,567.0,Facebook,72.0,Female,White / Caucasian,Highschool,Very conservative,Not at all aware,"['… are naturalistic in that they do not require researchers to directly interact with research volunteers', '… often capture social relationships not found using traditional methods (e.g. surveys)', '… are readily accessible to researchers and easy to collect']","['Creating fake accounts (""bots"")', 'Secretly changing the content of what users see', ""Hacking into users' accounts""]","['Public sentiment (e.g. environment-related concerns)', 'Social networks']",1,-1,2,"I think that ethical approval means that in their moral standards, they believe they are doing what is moral.",Somewhat unacceptable,no annonamous accounts should be accepted,,Somewhat unacceptable,there should't be annonamous accounts  that is like being untruthful,,Somewhat acceptable,this would be acceptable because the users were told of the research,,Somewhat unacceptable,i don't think that it's appropriate that anyone posts false information nor do i think that anyone should response to someone else's posts,,Extremely important,Very important,Very important,Very important,Very important,Extremely important,Extremely important,Extremely important,Very important,no annonamous accounts should be accepted,6.0,2.0,7.0,3.0,4.0,5.0,1.0,,10.0,,10.0,None,10.0
172,True,475.0,Facebook,30.0,Female,White / Caucasian,Master's degree or above,Slightly liberal,Very aware,"['… are large and can contain millions of data points', '… reflect events in real-time and can be collected continuously over time', '… are naturalistic in that they do not require researchers to directly interact with research volunteers', '… often capture social relationships not found using traditional methods (e.g. surveys)', '… are readily accessible to researchers and easy to collect']",['None of the above'],"['Political elections (e.g. voting behavior)', 'Presidential approval ratings', 'Well-being and economic satisfaction', 'Communication (e.g. spread of opinions and hate-speech)', 'Public sentiment (e.g. environment-related concerns)', 'News consumption (e.g. sharing of misinformation)', 'Social networks']",3,0,7,They must submit their research design to their institution and they will review it and make sure their methods and design is ethical and does not harm any participants.,Somewhat acceptable,,,Somewhat acceptable,participants were not aware they were being studied,if they told the participants later on that they were part of a study,Completely acceptable,,,Completely acceptable,,,Not at all important,Slightly important,Not at all important,Not at all important,Not at all important,Very important,Very important,Not at all important,Not at all important,,7.0,1.0,3.0,4.0,2.0,6.0,5.0,,,,,,
173,True,563.0,Reddit,25.0,Male,Asian - Indian,Highschool,Very liberal,Moderately aware,"['… are large and can contain millions of data points', '… reflect events in real-time and can be collected continuously over time', '… are naturalistic in that they do not require researchers to directly interact with research volunteers', '… often capture social relationships not found using traditional methods (e.g. surveys)', '… are readily accessible to researchers and easy to collect']","['Privately messaging users', ""Publicly posting on users' profiles"", 'Creating fake accounts (""bots"")']","['Political elections (e.g. voting behavior)', 'Health topics (e.g. spread of diseases)', 'Well-being and economic satisfaction', 'Communication (e.g. spread of opinions and hate-speech)', 'Public sentiment (e.g. environment-related concerns)', 'News consumption (e.g. sharing of misinformation)', 'Social networks']",3,3,7,This means that their institution needs to ensure that their study will not violate the rights of others nor will mislead to manipulate others in a negative manner.,Completely acceptable,i might be interested in what counted as hate speech in this study,,Somewhat acceptable,i wondered why they didn't do this for neutral or left leaning users too,i would care to know how extreme these users were,Completely acceptable,,if the sample was truly neutral or not,Somewhat acceptable,,whether or not they used reputable face checkers,Slightly important,Moderately important,Slightly important,Slightly important,Moderately important,Very important,Very important,Moderately important,Extremely important,,5.0,7.0,2.0,3.0,1.0,4.0,6.0,,,,,,
174,True,475.0,Facebook,27.0,Male,White / Caucasian,Highschool,Very conservative,Extremely aware,['… are large and can contain millions of data points'],"['Creating fake accounts (""bots"")', ""Hacking into users' accounts""]","['Political elections (e.g. voting behavior)', 'Health topics (e.g. spread of diseases)', 'Well-being and economic satisfaction', 'Public sentiment (e.g. environment-related concerns)', 'News consumption (e.g. sharing of misinformation)']",1,0,5,Approval that keeps up with all moral standards and expectations  ,Completely acceptable,,,Neutral,,,Completely acceptable,,,Completely unacceptable,people being puppets is never okay,people being aware there being in a research study,Very important,Moderately important,Extremely important,Moderately important,Moderately important,Very important,Very important,Extremely important,Very important,,6.0,4.0,1.0,5.0,2.0,7.0,3.0,,,,,,
175,True,1206.0,Facebook,53.0,Male,White / Caucasian,Bachelor's degree,Slightly liberal,Moderately aware,"['… are large and can contain millions of data points', '… reflect events in real-time and can be collected continuously over time', '… often capture social relationships not found using traditional methods (e.g. surveys)', '… are readily accessible to researchers and easy to collect']","['Privately messaging users', ""Publicly posting on users' profiles""]","['Political elections (e.g. voting behavior)', 'Economic forecasting', 'Presidential approval ratings', 'Communication (e.g. spread of opinions and hate-speech)', 'Public sentiment (e.g. environment-related concerns)', 'News consumption (e.g. sharing of misinformation)', 'Social networks']",2,2,7,To make sure the experiment is morally and legally viable.,Somewhat acceptable,was it expressive empathy on par with the hateful speech? agreeing with rhetoric etc?,None,Neutral,that they did not know they were in a study,did you present yourself as a friend in the message? or how?,Somewhat acceptable,None,what info they were reading on the sites,Somewhat acceptable,they did not know it was an experiment but it seems harmless here,they may have known it was a bot,Extremely important,Extremely important,Extremely important,Extremely important,Extremely important,Extremely important,Extremely important,Extremely important,Extremely important,all of these aspects are vital to have,6.0,4.0,5.0,1.0,3.0,7.0,2.0,,,,,,
176,True,2435.0,Facebook,57.0,Male,White / Caucasian,Bachelor's degree,Neutral/ Neither conservative or liberal,Moderately aware,"['… are large and can contain millions of data points', '… reflect events in real-time and can be collected continuously over time', '… are naturalistic in that they do not require researchers to directly interact with research volunteers', '… often capture social relationships not found using traditional methods (e.g. surveys)', '… are readily accessible to researchers and easy to collect']","['Privately messaging users', ""Publicly posting on users' profiles"", 'Creating fake accounts (""bots"")']","['Political elections (e.g. voting behavior)', 'Economic forecasting', 'Presidential approval ratings', 'Health topics (e.g. spread of diseases)', 'Well-being and economic satisfaction', 'Communication (e.g. spread of opinions and hate-speech)', 'Public sentiment (e.g. environment-related concerns)', 'News consumption (e.g. sharing of misinformation)', 'Social networks']",3,3,9,The experiment must comply with the ethical standards established by the institution.,Completely acceptable,,,Completely acceptable,,,Completely acceptable,,,Completely acceptable,,,Extremely important,Slightly important,Moderately important,Slightly important,Slightly important,Extremely important,Slightly important,Slightly important,Extremely important,the bias of the researchershow the research is fundedhow the researchers are compensated,7.0,3.0,4.0,5.0,1.0,6.0,2.0,,,,,,
177,True,514.0,Facebook,50.0,Female,White / Caucasian,Highschool,Slightly conservative,Moderately aware,"['… are large and can contain millions of data points', '… often capture social relationships not found using traditional methods (e.g. surveys)', '… are readily accessible to researchers and easy to collect']","['Creating fake accounts (""bots"")', ""Hacking into users' accounts""]","['Political elections (e.g. voting behavior)', 'Economic forecasting', 'Presidential approval ratings', 'News consumption (e.g. sharing of misinformation)']",1,0,4,I think it means that something is approved in a moral and honest manner,Somewhat unacceptable,it's not right to trick people into things,,Somewhat unacceptable,researchers need to be up front and let someone know what the truth is,,Completely acceptable,it's the right thing to do to let people know the truth,,Somewhat unacceptable,,,Moderately important,Slightly important,Extremely important,Moderately important,Very important,Very important,Extremely important,Moderately important,Very important,,7.0,1.0,6.0,3.0,4.0,5.0,2.0,,,,,,
178,True,828.0,Facebook,45.0,Female,White / Caucasian,Bachelor's degree,Slightly liberal,Slightly aware,"['… are large and can contain millions of data points', '… reflect events in real-time and can be collected continuously over time', '… are naturalistic in that they do not require researchers to directly interact with research volunteers', '… are readily accessible to researchers and easy to collect']","[""Publicly posting on users' profiles"", 'Creating fake accounts (""bots"")']","['Political elections (e.g. voting behavior)', 'Economic forecasting', 'Presidential approval ratings', 'Health topics (e.g. spread of diseases)', 'Well-being and economic satisfaction', 'Communication (e.g. spread of opinions and hate-speech)', 'Public sentiment (e.g. environment-related concerns)', 'News consumption (e.g. sharing of misinformation)', 'Social networks']",2,2,9,I think that ethical approval means that the researchers can't purposefully hurt anyone. They need to have participants be aware of any negative consequences.,Somewhat acceptable,"this one i am on the fence about i feel like it was ok to do this, but the twitter users were never told that they were part of the research",tell the twitter users after that they were part of the research project,Somewhat unacceptable,why only right leaning twitter accounts? further to message someone is very targeting and i wonder if that invades a persons privacy,target left leaning accounts alos,Somewhat acceptable,they told the study participants that they were being studied,,Completely acceptable,"i would say one concern is that if one publicly goes against the original poster, would the original poster get angry for someone disagreeing with them",,Extremely important,Moderately important,Not at all important,Slightly important,Not at all important,Extremely important,Extremely important,Extremely important,Extremely important,whether it was biased for one side or another,7.0,4.0,6.0,5.0,1.0,2.0,3.0,,1.0,,,,
179,True,1156.0,Reddit,48.0,Male,White / Caucasian,Highschool,Very liberal,Moderately aware,"['… are large and can contain millions of data points', '… reflect events in real-time and can be collected continuously over time', '… are naturalistic in that they do not require researchers to directly interact with research volunteers', '… often capture social relationships not found using traditional methods (e.g. surveys)', '… are readily accessible to researchers and easy to collect']","[""Publicly posting on users' profiles"", 'Creating fake accounts (""bots"")']","['Political elections (e.g. voting behavior)', 'Presidential approval ratings', 'Health topics (e.g. spread of diseases)', 'Communication (e.g. spread of opinions and hate-speech)', 'Public sentiment (e.g. environment-related concerns)', 'News consumption (e.g. sharing of misinformation)', 'Social networks']",3,2,7,"Ethical approval means that the researchers can't do anything the subjects don't know about, as in they have to be forthcoming about the research. They can't do anything harmful to the subjects, and they have to be open about the data, and who has access.",Somewhat acceptable,"while i don't really like that the people don't know they are a part of research, i find this less bad since the repliespoststweets are already public and possible because i like the results",,Somewhat unacceptable,"i don't know that i can get behind something where the subject doesn't know they are part of the research i understand that the results are more 'real world', but i feel like it is deceptive to not inform people of what is happening, even if that would skew the results",,Completely acceptable,"as long as each user knew what the researchers had access to, i think this is fine",,Neutral,"i like the idea of this study, however, the results are kind of terrifying i find it fine, as it is no more unethical than something a partisan on the other side of the issue might do",,Not at all important,Not at all important,Not at all important,Not at all important,Not at all important,Moderately important,Very important,Slightly important,Not at all important,"i think the only real large aspect that i have any issue with is the knowledge of the participant that is a slight sticking point for me, but i could probably overcome it with good enough reasoning",7.0,2.0,5.0,6.0,1.0,4.0,3.0,"interactions with participants (on a public medium) should be public, not in dm's",3.0,,,,
180,True,515.0,Reddit,39.0,Male,White / Caucasian,Highschool,Very liberal,Very aware,"['… are large and can contain millions of data points', '… are naturalistic in that they do not require researchers to directly interact with research volunteers', '… often capture social relationships not found using traditional methods (e.g. surveys)', '… are readily accessible to researchers and easy to collect']","['Creating fake accounts (""bots"")', 'Secretly changing the content of what users see']","['Political elections (e.g. voting behavior)', 'Economic forecasting', 'Presidential approval ratings', 'Health topics (e.g. spread of diseases)', 'Well-being and economic satisfaction', 'Communication (e.g. spread of opinions and hate-speech)', 'Public sentiment (e.g. environment-related concerns)', 'News consumption (e.g. sharing of misinformation)', 'Social networks']",2,0,9,It means that the experiment does no harm to the participant either directly or indirectly.,Somewhat acceptable,how is this bad? it's literally making the internet a better place,,Neutral,,,Somewhat acceptable,"i mean, its expanding people out of their comfort zones so",,Somewhat acceptable,"so basically trolling , but with fact checking",,Moderately important,Very important,Very important,Very important,Moderately important,Moderately important,Moderately important,Very important,Very important,,4.0,7.0,3.0,2.0,1.0,5.0,6.0,,,,,,
181,True,1072.0,Facebook,74.0,Female,White / Caucasian,Bachelor's degree,Slightly conservative,Moderately aware,"['… reflect events in real-time and can be collected continuously over time', '… are naturalistic in that they do not require researchers to directly interact with research volunteers', '… often capture social relationships not found using traditional methods (e.g. surveys)', '… are readily accessible to researchers and easy to collect']","[""Publicly posting on users' profiles""]","['Political elections (e.g. voting behavior)', 'Presidential approval ratings', 'Health topics (e.g. spread of diseases)', 'Public sentiment (e.g. environment-related concerns)']",2,1,4,"ensures that all questions, opinions , statements are not offensive to any particular race, religion, group.",Completely unacceptable,"again, researches are wrong to use people as part of a study without their knowledge",it was wrong to respond without being who you say you are,Completely unacceptable,people should always be aware that they are part of a study,unethical to trick people to be part of a  study,Somewhat unacceptable,people were encouraged to be followed and tracked for a very small reward,people were used for the researchers purposes,Completely unacceptable,people should be aware that they are part of a research study,unacceptable that researchers were looking for particular accounts without telling the people,Very important,Very important,Very important,Very important,Very important,Very important,Extremely important,Very important,Very important,so many studies may be done on so many people without their knowledge,7.0,1.0,6.0,2.0,3.0,5.0,4.0,,0.0,,0.0,,0.0
182,True,1089.0,Facebook,59.0,Female,White / Caucasian,Associate's degree,Very liberal,Moderately aware,"['… are large and can contain millions of data points', '… often capture social relationships not found using traditional methods (e.g. surveys)', '… are readily accessible to researchers and easy to collect']",['None of the above'],"['Communication (e.g. spread of opinions and hate-speech)', 'Public sentiment (e.g. environment-related concerns)', 'News consumption (e.g. sharing of misinformation)']",1,0,3,Approval from higher ups that the information they are seeking be done in an ethical manner ,Completely acceptable,i think anytime you post or share on social media you are fair game to be analyzed by researchers,,Completely acceptable,,,Completely acceptable,,,Completely acceptable,,,Not at all important,Not at all important,Moderately important,Not at all important,Not at all important,Not at all important,Not at all important,Slightly important,Moderately important,,6.0,7.0,2.0,3.0,1.0,4.0,5.0,,,,,,
183,True,452.0,Reddit,43.0,Male,Carribean,Highschool,Slightly conservative,Very aware,"['… are large and can contain millions of data points', '… reflect events in real-time and can be collected continuously over time', '… are readily accessible to researchers and easy to collect']",['Privately messaging users'],"['Political elections (e.g. voting behavior)', 'Economic forecasting', 'Presidential approval ratings', 'Health topics (e.g. spread of diseases)', 'Public sentiment (e.g. environment-related concerns)', 'Social networks']",1,1,6,that the study follows all the rules ,Somewhat unacceptable,,,Somewhat acceptable,,,Completely unacceptable,watching what someone views and looks at is an extremely invasion of privacy,,Somewhat unacceptable,,,Extremely important,Very important,Very important,Slightly important,Slightly important,Slightly important,Extremely important,Moderately important,Extremely important,,7.0,2.0,1.0,3.0,4.0,6.0,5.0,,,,,,
184,True,926.0,Twitter,26.0,Male,White / Caucasian,Bachelor's degree,Slightly conservative,Very aware,"['… are large and can contain millions of data points', '… reflect events in real-time and can be collected continuously over time', '… are naturalistic in that they do not require researchers to directly interact with research volunteers', '… often capture social relationships not found using traditional methods (e.g. surveys)', '… are readily accessible to researchers and easy to collect', '… are always representative of people’s offline behavior', '… are unaffected by the way social media platforms work', '… are well formatted and never contain any missing data']","['Privately messaging users', ""Publicly posting on users' profiles"", 'Creating fake accounts (""bots"")', 'Secretly changing the content of what users see', ""Hacking into users' accounts""]","['Political elections (e.g. voting behavior)', 'Economic forecasting', 'Presidential approval ratings', 'Health topics (e.g. spread of diseases)', 'Well-being and economic satisfaction', 'Communication (e.g. spread of opinions and hate-speech)', 'Public sentiment (e.g. environment-related concerns)', 'News consumption (e.g. sharing of misinformation)', 'Social networks']",0,1,9,Ethical Approval is the very important all sites. ,Neutral,,,Neutral,,,Neutral,,,Neutral,,,Very important,Moderately important,Very important,Very important,Very important,Very important,Very important,Moderately important,Very important,None,5.0,3.0,2.0,1.0,6.0,7.0,4.0,None,1.0,just study and fair study design,2.0,,3.0
185,True,981.0,Reddit,25.0,Male,White / Caucasian,Bachelor's degree,Slightly liberal,Not at all aware,"['… are large and can contain millions of data points', '… reflect events in real-time and can be collected continuously over time', '… are naturalistic in that they do not require researchers to directly interact with research volunteers', '… often capture social relationships not found using traditional methods (e.g. surveys)', '… are readily accessible to researchers and easy to collect']","['Privately messaging users', ""Publicly posting on users' profiles"", 'Creating fake accounts (""bots"")']","['Political elections (e.g. voting behavior)', 'Economic forecasting', 'Presidential approval ratings', 'Health topics (e.g. spread of diseases)', 'Well-being and economic satisfaction', 'Communication (e.g. spread of opinions and hate-speech)', 'Public sentiment (e.g. environment-related concerns)', 'News consumption (e.g. sharing of misinformation)', 'Social networks']",3,3,9,"I feel that this is a verbal, or written confirmation, that it is okay to proceed with their experiments. I believe that whatever the experiment is, the institution thinks it is morally okay to do.",Completely acceptable,it seems like the data backs up that this was a positive thing to do,,Completely acceptable,i don't see anything wrong with this doesn't hurt anyone,,Completely acceptable,seems ethically acceptable to me,,Completely acceptable,i think this is okay no one is getting hurt and they are attempting to show truth,,Extremely important,Very important,Extremely important,Very important,Moderately important,Moderately important,Moderately important,Very important,Extremely important,,1.0,7.0,2.0,5.0,6.0,4.0,3.0,,,,,,
186,True,1262.0,Facebook,31.0,Female,White / Caucasian,Highschool,Slightly liberal,Slightly aware,"['… are large and can contain millions of data points', '… are naturalistic in that they do not require researchers to directly interact with research volunteers', '… often capture social relationships not found using traditional methods (e.g. surveys)', '… are readily accessible to researchers and easy to collect']","['Creating fake accounts (""bots"")']","['Political elections (e.g. voting behavior)', 'Economic forecasting', 'Presidential approval ratings', 'Well-being and economic satisfaction', 'Communication (e.g. spread of opinions and hate-speech)', 'Public sentiment (e.g. environment-related concerns)', 'News consumption (e.g. sharing of misinformation)', 'Social networks']",2,1,8,I believe ethical approval would be an approval from the board certifying that they do not see any potential conflict between the study and the ethical principals of their institution. ,Completely acceptable,the information obtained from this study is already public information as it was posted in a public forum non-invasive and therefore ethically acceptable,,Completely acceptable,,,Somewhat acceptable,"since it was incentivized for the participants, i find it ethically acceptable","if the study did not clearly communicate to the participants that the browser extension would record what they were viewing, then i would find the study much less ethically acceptable consent is important for participation in that level of surveillance",Completely acceptable,,,Very important,Very important,Slightly important,Not at all important,Not at all important,Slightly important,Moderately important,Not at all important,Moderately important,"explicit consent, if the data collected would not typically be publicly found (the browser extension surveillance vs a comment publicly)",3.0,4.0,5.0,7.0,1.0,6.0,2.0,,,,,,
187,True,528.0,Facebook,41.0,Female,White / Caucasian,Highschool,Slightly liberal,Slightly aware,"['… are large and can contain millions of data points', '… reflect events in real-time and can be collected continuously over time', '… often capture social relationships not found using traditional methods (e.g. surveys)', '… are readily accessible to researchers and easy to collect']","['Privately messaging users', 'Creating fake accounts (""bots"")']","['Political elections (e.g. voting behavior)', 'Well-being and economic satisfaction', 'Communication (e.g. spread of opinions and hate-speech)', 'Public sentiment (e.g. environment-related concerns)', 'News consumption (e.g. sharing of misinformation)', 'Social networks']",2,2,6,Ethical ways of retrieving information,Somewhat acceptable,,,Somewhat acceptable,,,Completely acceptable,,,Somewhat acceptable,,,Very important,Slightly important,Moderately important,Moderately important,Moderately important,Very important,Very important,Very important,Moderately important,,7.0,4.0,5.0,3.0,2.0,6.0,1.0,,,,,,
188,True,613.0,Facebook,52.0,Female,White / Caucasian,Bachelor's degree,Slightly conservative,Slightly aware,"['… are large and can contain millions of data points', '… reflect events in real-time and can be collected continuously over time', '… often capture social relationships not found using traditional methods (e.g. surveys)']","['Privately messaging users', 'Creating fake accounts (""bots"")']","['Political elections (e.g. voting behavior)', 'Presidential approval ratings', 'Health topics (e.g. spread of diseases)', 'Well-being and economic satisfaction', 'Communication (e.g. spread of opinions and hate-speech)', 'Public sentiment (e.g. environment-related concerns)', 'News consumption (e.g. sharing of misinformation)', 'Social networks']",3,2,8,Ethical behavior involves informed consent on the part of the study participants.  It requires that the researchers use best practices and full confidentiality.  ,Somewhat unacceptable,"who determines what is ""hate"" speech?  again it seems manipulative",i'd like to know what the original tweets were,Somewhat unacceptable,"why only target ""right leaning"" tweets?  are conservatives the only ones who are assumed to be sharing ""misinformation""  seems like a biased study",,Completely acceptable,all parties seemingly knew what they were getting into,,Neutral,,,Slightly important,Moderately important,Moderately important,Moderately important,Moderately important,Very important,Very important,Very important,Slightly important,,3.0,1.0,4.0,2.0,6.0,7.0,5.0,,,,,,
189,True,867.0,Reddit,34.0,Male,White / Caucasian,Bachelor's degree,Very liberal,Not at all aware,"['… are large and can contain millions of data points', '… reflect events in real-time and can be collected continuously over time', '… are naturalistic in that they do not require researchers to directly interact with research volunteers', '… often capture social relationships not found using traditional methods (e.g. surveys)', '… are readily accessible to researchers and easy to collect']","['Privately messaging users', 'Creating fake accounts (""bots"")']","['Political elections (e.g. voting behavior)', 'Presidential approval ratings', 'Well-being and economic satisfaction', 'Communication (e.g. spread of opinions and hate-speech)', 'Public sentiment (e.g. environment-related concerns)', 'News consumption (e.g. sharing of misinformation)', 'Social networks']",3,2,7,I would think ethical approval means whether or not their intended research topic and methods of acquiring data is ethical. Researches likely have to submit an outline of their intention and plan of action for review in order to determine they are not acting outside of ethical boundaries.,Neutral,"my only concern is the fact that the ""participants"" are not aware that they are participating in this study and have not given consent i find the topic interesting and certainly do not support hate speech",,Neutral,"again, the participants are not aware that they are partaking in a study they did not give consent that is my only concern",,Somewhat acceptable,i like how they acquired consent and used willing participants in this study,,Neutral,consent remains an issue participants are unaware they are being utilizes in a study i think there is an argument though that there is little to no harm being done to the participants,,Moderately important,Not at all important,Slightly important,Slightly important,Not at all important,Moderately important,Very important,Moderately important,Moderately important,,7.0,1.0,5.0,4.0,2.0,3.0,6.0,,,,,,
190,True,491.0,Facebook,29.0,Male,White / Caucasian,Highschool,Slightly conservative,Moderately aware,"['… are large and can contain millions of data points', '… reflect events in real-time and can be collected continuously over time', '… often capture social relationships not found using traditional methods (e.g. surveys)', '… are readily accessible to researchers and easy to collect']",['None of the above'],"['Presidential approval ratings', 'Health topics (e.g. spread of diseases)', 'News consumption (e.g. sharing of misinformation)', 'Social networks']",2,0,4,If something is right enough for the public.,Somewhat acceptable,,,Somewhat unacceptable,,,Completely acceptable,,,Somewhat unacceptable,,,Extremely important,Extremely important,Slightly important,Extremely important,Extremely important,Moderately important,Moderately important,Very important,Very important,,2.0,4.0,7.0,6.0,1.0,3.0,5.0,,,,,,
191,True,680.0,Reddit,26.0,Female,Mixed race,Highschool,Neutral/ Neither conservative or liberal,Not at all aware,"['… are large and can contain millions of data points', '… are readily accessible to researchers and easy to collect', '… are always representative of people’s offline behavior']",['None of the above'],"['Health topics (e.g. spread of diseases)', 'Communication (e.g. spread of opinions and hate-speech)', 'Public sentiment (e.g. environment-related concerns)']",-1,0,3,They  need to be approved before going forward with the study ,Completely acceptable,,,Neutral,,,Completely acceptable,,,Somewhat acceptable,,,Slightly important,Slightly important,Moderately important,Slightly important,Not at all important,Not at all important,Extremely important,Extremely important,Moderately important,whether the people knew or not is a huge factor,3.0,4.0,2.0,1.0,5.0,6.0,7.0,,0.0,,0.0,,0.0
192,True,473.0,Facebook,40.0,Female,White / Caucasian,Bachelor's degree,Very liberal,Moderately aware,"['… are large and can contain millions of data points', '… reflect events in real-time and can be collected continuously over time', '… are naturalistic in that they do not require researchers to directly interact with research volunteers', '… are readily accessible to researchers and easy to collect']","['Privately messaging users', 'Creating fake accounts (""bots"")']","['Political elections (e.g. voting behavior)', 'Presidential approval ratings', 'Communication (e.g. spread of opinions and hate-speech)', 'Public sentiment (e.g. environment-related concerns)', 'Social networks']",2,2,5,The means that the data is collected is not invading any privacy concerns or other concerns that may arise from unknown participants. ,Completely acceptable,,,Completely acceptable,,,Somewhat acceptable,i would only be concerned that data would not stop being collected after the 8 week time,how do they delete the data after the 8 weeks from the extension,Somewhat acceptable,the user may thing the link is a scam,,Extremely important,Extremely important,Extremely important,Extremely important,Extremely important,Very important,Very important,Very important,Moderately important,,7.0,3.0,5.0,2.0,4.0,6.0,1.0,,8.0,,9.0,,10.0
193,True,523.0,Twitter,29.0,Male,White / Caucasian,Highschool,Slightly conservative,Not at all aware,"['… are large and can contain millions of data points', '… reflect events in real-time and can be collected continuously over time', '… are naturalistic in that they do not require researchers to directly interact with research volunteers', '… often capture social relationships not found using traditional methods (e.g. surveys)', '… are readily accessible to researchers and easy to collect']",['None of the above'],"['Political elections (e.g. voting behavior)', 'Economic forecasting', 'Presidential approval ratings', 'Health topics (e.g. spread of diseases)', 'Well-being and economic satisfaction', 'Communication (e.g. spread of opinions and hate-speech)', 'Public sentiment (e.g. environment-related concerns)', 'News consumption (e.g. sharing of misinformation)', 'Social networks']",3,0,9,The people agree that the experiments are for a good cause.,Somewhat acceptable,,,Somewhat unacceptable,,,Somewhat unacceptable,,,Completely acceptable,,,Extremely important,Not at all important,Extremely important,Slightly important,Not at all important,Slightly important,Extremely important,Not at all important,Extremely important,,7.0,4.0,5.0,3.0,2.0,6.0,1.0,,1.0,,2.0,,3.0
194,True,762.0,Reddit,44.0,Male,White / Caucasian,Highschool,Slightly liberal,Slightly aware,"['… are large and can contain millions of data points', '… reflect events in real-time and can be collected continuously over time', '… are naturalistic in that they do not require researchers to directly interact with research volunteers', '… often capture social relationships not found using traditional methods (e.g. surveys)']","[""Publicly posting on users' profiles"", 'Creating fake accounts (""bots"")', ""Hacking into users' accounts""]","['Political elections (e.g. voting behavior)', 'Economic forecasting', 'Presidential approval ratings', 'Health topics (e.g. spread of diseases)', 'Well-being and economic satisfaction', 'Communication (e.g. spread of opinions and hate-speech)', 'Public sentiment (e.g. environment-related concerns)', 'News consumption (e.g. sharing of misinformation)', 'Social networks']",4,1,9,They propose something to a board of elect.,Neutral,it’s probably bots posting in the first place,the original posts were probably from a troll farm,Neutral,,,Somewhat unacceptable,,,Neutral,,,Moderately important,Slightly important,Slightly important,Slightly important,Very important,Moderately important,Very important,Slightly important,Slightly important,,7.0,4.0,3.0,1.0,5.0,6.0,2.0,whether the institution is capable of being fair,1.0,what are the motives of the researcher,2.0,what are the motives of the institution and can it be proven that they’re being truthful,1.0
195,True,508.0,Reddit,57.0,Male,Hispanic,Master's degree or above,Very liberal,Very aware,"['… are large and can contain millions of data points', '… often capture social relationships not found using traditional methods (e.g. surveys)', '… are readily accessible to researchers and easy to collect']","['Privately messaging users', ""Publicly posting on users' profiles""]","['Political elections (e.g. voting behavior)', 'Economic forecasting', 'Presidential approval ratings', 'Health topics (e.g. spread of diseases)', 'Well-being and economic satisfaction', 'Communication (e.g. spread of opinions and hate-speech)', 'Public sentiment (e.g. environment-related concerns)', 'News consumption (e.g. sharing of misinformation)', 'Social networks']",1,2,9,This means that all parties understand the implications--benefits/risks--of their participation.,Somewhat acceptable,,,Somewhat acceptable,,,Completely acceptable,,,Somewhat acceptable,,,Very important,Very important,Extremely important,Very important,Very important,Moderately important,Extremely important,Very important,Very important,,5.0,3.0,6.0,4.0,1.0,7.0,2.0,,1.0,,1.0,,1.0
196,True,328.0,Facebook,35.0,Male,White / Caucasian,Bachelor's degree,Very liberal,Very aware,"['… are large and can contain millions of data points', '… reflect events in real-time and can be collected continuously over time', '… often capture social relationships not found using traditional methods (e.g. surveys)', '… are readily accessible to researchers and easy to collect']","['Privately messaging users', ""Publicly posting on users' profiles"", 'Creating fake accounts (""bots"")']","['Political elections (e.g. voting behavior)', 'Economic forecasting', 'Presidential approval ratings', 'Health topics (e.g. spread of diseases)', 'Well-being and economic satisfaction', 'Communication (e.g. spread of opinions and hate-speech)', 'Public sentiment (e.g. environment-related concerns)', 'News consumption (e.g. sharing of misinformation)', 'Social networks']",2,3,9,Making sure that both the researchers and the participants in the research are respected. ,Completely unacceptable,,,Somewhat acceptable,,,Somewhat acceptable,,,Completely unacceptable,,,Extremely important,Very important,Extremely important,Slightly important,Very important,Very important,Extremely important,Very important,Very important,,7.0,2.0,6.0,3.0,1.0,5.0,4.0,,1.0,,2.0,,3.0
197,True,1655.0,Twitter,41.0,Male,African-American,Bachelor's degree,Slightly liberal,Moderately aware,"['… are large and can contain millions of data points', '… reflect events in real-time and can be collected continuously over time', '… often capture social relationships not found using traditional methods (e.g. surveys)', '… are readily accessible to researchers and easy to collect']","['Privately messaging users', ""Publicly posting on users' profiles"", 'Creating fake accounts (""bots"")', 'Secretly changing the content of what users see']","['Presidential approval ratings', 'Health topics (e.g. spread of diseases)', 'Communication (e.g. spread of opinions and hate-speech)', 'Public sentiment (e.g. environment-related concerns)', 'News consumption (e.g. sharing of misinformation)', 'Social networks']",2,2,6,agreement that the research methods are not harmful or deceiving to users.,Somewhat acceptable,,,Neutral,"seems like social engineering tactics but then again, social media platforms themselves tend to use these tactics via algorithms anyway",,Completely acceptable,,,Neutral,,,Extremely important,Very important,Extremely important,Very important,Very important,Extremely important,Extremely important,Extremely important,Extremely important,i think the list above is comprehensive enough,7.0,2.0,5.0,3.0,1.0,6.0,4.0,,,,,,
198,True,662.0,Reddit,41.0,Male,White / Caucasian,Master's degree or above,Slightly conservative,Extremely aware,"['… are large and can contain millions of data points', '… reflect events in real-time and can be collected continuously over time', '… are naturalistic in that they do not require researchers to directly interact with research volunteers', '… often capture social relationships not found using traditional methods (e.g. surveys)', '… are readily accessible to researchers and easy to collect']","['Privately messaging users', ""Publicly posting on users' profiles"", 'Creating fake accounts (""bots"")', 'Secretly changing the content of what users see']","['Political elections (e.g. voting behavior)', 'Economic forecasting', 'Presidential approval ratings', 'Health topics (e.g. spread of diseases)', 'Well-being and economic satisfaction', 'Communication (e.g. spread of opinions and hate-speech)', 'Public sentiment (e.g. environment-related concerns)', 'News consumption (e.g. sharing of misinformation)', 'Social networks']",3,2,9,"It depends on what the data is being collected for, how its being collected, and is informed consent presented.  it gets tricky when data is collected, used, without informed consent on public information.  Thus social media, is that public information or not.  ",Somewhat unacceptable,,free speech (even hate speech depending on how its defined) is protected,Somewhat unacceptable,"again informed consent  they users were not told of this, but it happend",,Neutral,"the reasoning of the research study, it appears these people were not told why",,Completely unacceptable,"the people where not told what was going on, no informed consent  the use of bots supports elon musk of why twitter is bad",,Slightly important,Very important,Extremely important,Moderately important,Extremely important,Moderately important,Extremely important,Very important,Extremely important,free speech still must be protected,6.0,1.0,7.0,4.0,3.0,5.0,2.0,how will the person be compensated,8.0,,,,
199,True,647.0,Facebook,50.0,Female,White / Caucasian,Bachelor's degree,Slightly liberal,Slightly aware,"['… are large and can contain millions of data points', '… reflect events in real-time and can be collected continuously over time', '… are readily accessible to researchers and easy to collect']","['Creating fake accounts (""bots"")', 'Secretly changing the content of what users see']","['Political elections (e.g. voting behavior)', 'Presidential approval ratings', 'Health topics (e.g. spread of diseases)', 'Well-being and economic satisfaction', 'Communication (e.g. spread of opinions and hate-speech)', 'Public sentiment (e.g. environment-related concerns)', 'News consumption (e.g. sharing of misinformation)']",1,0,7,I think it means they won't intentionally harm anyone.,Somewhat acceptable,,i would like to know what they were saying,Neutral,i'm not sure if using bot to influence people is truly ethical,,Completely acceptable,they told the people what they were doing and they choose to participate,,Neutral,,,Very important,Moderately important,Moderately important,Very important,Very important,Moderately important,Extremely important,Moderately important,Moderately important,how they are collecting the data and if the participants are aware,2.0,4.0,1.0,5.0,3.0,7.0,6.0,,,,,,
200,True,1485.0,Reddit,34.0,Male,Asian - Eastern,Bachelor's degree,Slightly liberal,Very aware,"['… are large and can contain millions of data points', '… reflect events in real-time and can be collected continuously over time', '… often capture social relationships not found using traditional methods (e.g. surveys)', '… are readily accessible to researchers and easy to collect']","['Privately messaging users', ""Publicly posting on users' profiles"", 'Creating fake accounts (""bots"")', 'Secretly changing the content of what users see']","['Political elections (e.g. voting behavior)', 'Economic forecasting', 'Presidential approval ratings', 'Health topics (e.g. spread of diseases)', 'Well-being and economic satisfaction', 'Communication (e.g. spread of opinions and hate-speech)', 'Public sentiment (e.g. environment-related concerns)', 'News consumption (e.g. sharing of misinformation)', 'Social networks']",2,2,9,Requesting approval to access their database. ,Completely unacceptable,"completely unacceptable because researchers analyzed users data without their knowledge finally, the researchers analyzed the users' 1,000 public posts before receiving the public reply, and the users' public twitter behavior for 4 weeks after receiving the public reply participants were not aware they were part of a research study",study needs to be explicitly explain to participants what were analyzed and why,Neutral,"i like the fact that researchers reach out to participants privately however, they did not made known to to participants that they are part of the study",requesting permission and letting participants know would influence the study,Completely acceptable,no concerns at all users were offered choices and it was all voluntary,,Somewhat unacceptable,my main concern is that participants were not aware they were part of a research study,researchers should have let participants know first and request their permission,Very important,Moderately important,Moderately important,Very important,Very important,Very important,Extremely important,Very important,Extremely important,,6.0,5.0,7.0,2.0,3.0,4.0,1.0,,,,,,
201,True,692.0,Reddit,45.0,Male,White / Caucasian,Master's degree or above,Slightly liberal,Very aware,"['… are large and can contain millions of data points', '… reflect events in real-time and can be collected continuously over time', '… are naturalistic in that they do not require researchers to directly interact with research volunteers', '… are readily accessible to researchers and easy to collect']","['Creating fake accounts (""bots"")']","['Political elections (e.g. voting behavior)', 'Health topics (e.g. spread of diseases)', 'Communication (e.g. spread of opinions and hate-speech)', 'News consumption (e.g. sharing of misinformation)', 'Social networks']",2,1,5,It means that the researcher submits a proposed study and method to an institutional review board who reads over the proposal to ensure that the researchers are not doing anything that will cause harm and are open about their procedures. Deception must be disclosed and people asked if they are okay with their data being used in the case of deception. Social media type studies may not receive the same scrutiny if all that is going on is observation of existing posts and NO manipulation of the online environment with bots or fictional posts meant to elicit reactions.,Somewhat acceptable,the researchers should demonstrate that their posts are not inflammatory toward the hate speech users to further inflame,i would want to see the content of the posts presumably they were standardized across hate poster,Somewhat unacceptable,this involves privately target individuals outside of a public system many online would view this as harassment,what evidence they had that there were no risks associated with direct communication,Neutral,i am concerned about what exactly is tracked and how the data of the participants are protected,i want to see what measures are used to protect participant identity,Somewhat acceptable,fake accounts are not going to be well received one knows of bots the unintended consequences of this activity may be more negativity what does the risk for violence look like?,sounds like the message they are using is pretty straight forward and simple,Very important,Not at all important,Not at all important,Slightly important,Not at all important,Very important,Moderately important,Very important,Moderately important,,6.0,5.0,4.0,2.0,1.0,3.0,7.0,,,,,,
202,True,444.0,Facebook,65.0,Male,White / Caucasian,Prefer not to say,Slightly conservative,Very aware,"['… are large and can contain millions of data points', '… reflect events in real-time and can be collected continuously over time', '… are naturalistic in that they do not require researchers to directly interact with research volunteers', '… often capture social relationships not found using traditional methods (e.g. surveys)', '… are readily accessible to researchers and easy to collect', '… are always representative of people’s offline behavior']","['Privately messaging users', ""Publicly posting on users' profiles"", 'Creating fake accounts (""bots"")']","['Political elections (e.g. voting behavior)', 'Economic forecasting', 'Presidential approval ratings', 'Health topics (e.g. spread of diseases)', 'Well-being and economic satisfaction', 'Communication (e.g. spread of opinions and hate-speech)', 'Public sentiment (e.g. environment-related concerns)', 'News consumption (e.g. sharing of misinformation)', 'Social networks']",2,3,9,Permission to be able to use their data,Somewhat acceptable,,,Neutral,,,Neutral,,,Somewhat unacceptable,,,Moderately important,Very important,Very important,Very important,Moderately important,Very important,Moderately important,Very important,Very important,None,7.0,1.0,2.0,3.0,5.0,6.0,4.0,,,,,,
203,True,1218.0,Facebook,71.0,Male,White / Caucasian,Master's degree or above,Very conservative,Slightly aware,"['… are large and can contain millions of data points', '… reflect events in real-time and can be collected continuously over time', '… often capture social relationships not found using traditional methods (e.g. surveys)', '… are readily accessible to researchers and easy to collect']","['Privately messaging users', ""Publicly posting on users' profiles""]","['Political elections (e.g. voting behavior)', 'Economic forecasting', 'Presidential approval ratings', 'Health topics (e.g. spread of diseases)', 'Communication (e.g. spread of opinions and hate-speech)', 'Public sentiment (e.g. environment-related concerns)', 'News consumption (e.g. sharing of misinformation)']",2,2,7,They need to get the institution to understand that they are doing research and have no intention of harming in any way the people they are looking at.  They are not promoting an agenda but instead studying various things to come to conclusions about the things that they are studying.,Somewhat unacceptable,"define hate speech  if i say that the 2020 election was a fraud, some people would call that hate speech  and again participants were not made aware that they were subjects of a study",,Somewhat acceptable,i don't like the idea of being able to create twitter accounts  and their purpose to reduce sharing misinformation is very subjective based on personal political bias there are very few conservatives in academia,,Somewhat acceptable,"this was ok in my opinion, but a little underpaid  and i don't like the idea of installing a browser extension  i wouldn't do it too dangerous",,Somewhat unacceptable,professional fact checkers are suspect at best and mainly political hacks  this is proving nothing and no one was told that this was being done  and this sounds too subjective to be of any value,fact checkers will tell you that mrna vaccines are safe to that i say myocarditis,Moderately important,Very important,Very important,Slightly important,Very important,Moderately important,Very important,Slightly important,Moderately important,"in quite a few of the studies, people were bated into posting and their responses were being evaluated without them knowing it data at times can be used inappropriately",7.0,1.0,4.0,5.0,3.0,6.0,2.0,that their data won't be sold to outside companies,4.0,,,,
204,True,1029.0,Facebook,47.0,Male,White / Caucasian,Highschool,Neutral/ Neither conservative or liberal,Slightly aware,['None of the above'],['None of the above'],['None of the above'],0,0,0,I would assume it means that their methods have been deemed ethical by the institution. ,Neutral,,,Completely unacceptable,,,Completely acceptable,,,Completely unacceptable,,,Moderately important,Not at all important,Moderately important,Slightly important,Moderately important,Very important,Very important,Moderately important,Very important,,5.0,2.0,6.0,3.0,1.0,7.0,4.0,,,,,,
205,True,606.0,Facebook,34.0,Male,White / Caucasian,Highschool,Slightly conservative,Not at all aware,"['… are large and can contain millions of data points', '… reflect events in real-time and can be collected continuously over time', '… are readily accessible to researchers and easy to collect']",['None of the above'],"['Political elections (e.g. voting behavior)', 'Presidential approval ratings', 'Public sentiment (e.g. environment-related concerns)', 'News consumption (e.g. sharing of misinformation)']",1,0,4,I think it would probably entail them agreeing not to do things that are dishonest or unethical throughout their research.,Somewhat acceptable,,,Somewhat acceptable,,,Completely acceptable,,,Somewhat acceptable,,,Moderately important,Not at all important,Slightly important,Not at all important,Moderately important,Moderately important,Moderately important,Slightly important,Slightly important,,7.0,4.0,6.0,3.0,2.0,5.0,1.0,,,,,,
206,True,583.0,Reddit,34.0,Male,White / Caucasian,Master's degree or above,Slightly liberal,Very aware,"['… are large and can contain millions of data points', '… reflect events in real-time and can be collected continuously over time', '… are naturalistic in that they do not require researchers to directly interact with research volunteers', '… often capture social relationships not found using traditional methods (e.g. surveys)', '… are readily accessible to researchers and easy to collect']","['Privately messaging users', 'Creating fake accounts (""bots"")']","['Political elections (e.g. voting behavior)', 'Health topics (e.g. spread of diseases)', 'Well-being and economic satisfaction', 'Communication (e.g. spread of opinions and hate-speech)', 'News consumption (e.g. sharing of misinformation)', 'Social networks']",3,2,6,I think that people who are higher up in the institution need to deem it as something that is ethical and will produce results that are actually needed and necessary.,Completely acceptable,i think that the results that were generated from this study show that it was a good thing that it was done,,Completely acceptable,i think that the people who got private messages could have easily ignored them but they didn't which shows that it was a good and ethical study messages can always and easily be ignored,,Completely acceptable,i think that more money maybe should have been available for people who took part since the time for it was a decent amount of time,,Completely acceptable,i think that this was a good test to do and see what would happen,,Very important,Extremely important,Extremely important,Extremely important,Very important,Very important,Not at all important,Extremely important,Very important,,5.0,7.0,4.0,2.0,6.0,1.0,3.0,,,,,,
207,True,655.0,Reddit,76.0,Male,White / Caucasian,Bachelor's degree,Very liberal,Slightly aware,"['… are large and can contain millions of data points', '… reflect events in real-time and can be collected continuously over time', '… often capture social relationships not found using traditional methods (e.g. surveys)', '… are readily accessible to researchers and easy to collect']","['Creating fake accounts (""bots"")']","['Presidential approval ratings', 'Health topics (e.g. spread of diseases)', 'Well-being and economic satisfaction', 'Communication (e.g. spread of opinions and hate-speech)', 'Public sentiment (e.g. environment-related concerns)', 'Social networks']",2,1,6,"The institution must give permission if the research is done ethically, that is with honest real means to carry out the research. No deception or nefarious purpose.",Somewhat acceptable,,,Somewhat acceptable,,,Neutral,,,Neutral,,,Very important,Very important,Very important,Moderately important,Very important,Very important,Moderately important,Extremely important,Very important,,7.0,5.0,4.0,2.0,1.0,6.0,3.0,,,,,,
208,True,889.0,Facebook,51.0,Female,White / Caucasian,Bachelor's degree,Very liberal,Slightly aware,"['… are large and can contain millions of data points', '… reflect events in real-time and can be collected continuously over time', '… are naturalistic in that they do not require researchers to directly interact with research volunteers', '… are readily accessible to researchers and easy to collect', '… are always representative of people’s offline behavior']","['Privately messaging users', ""Publicly posting on users' profiles"", 'Creating fake accounts (""bots"")', 'Secretly changing the content of what users see']","['Political elections (e.g. voting behavior)', 'Presidential approval ratings', 'Health topics (e.g. spread of diseases)', 'Well-being and economic satisfaction', 'Communication (e.g. spread of opinions and hate-speech)', 'Public sentiment (e.g. environment-related concerns)', 'News consumption (e.g. sharing of misinformation)', 'Social networks']",1,2,8,I think it means the researchers must make the intentions clear and stick to guidelines so they do not do something unlawful or wrong with the material they use.,Neutral,,,Somewhat acceptable,,,Completely acceptable,,,Neutral,,,Very important,Moderately important,Extremely important,Moderately important,Extremely important,Very important,Very important,Very important,Very important,,7.0,6.0,4.0,5.0,3.0,1.0,2.0,,,,,,
209,True,1314.0,Twitter,51.0,Male,White / Caucasian,Highschool,Very liberal,Moderately aware,"['… are large and can contain millions of data points', '… are naturalistic in that they do not require researchers to directly interact with research volunteers', '… often capture social relationships not found using traditional methods (e.g. surveys)']","['Privately messaging users', ""Publicly posting on users' profiles"", 'Creating fake accounts (""bots"")', 'Secretly changing the content of what users see']","['Political elections (e.g. voting behavior)', 'Economic forecasting', 'Presidential approval ratings', 'Health topics (e.g. spread of diseases)', 'Well-being and economic satisfaction', 'Communication (e.g. spread of opinions and hate-speech)', 'Public sentiment (e.g. environment-related concerns)', 'News consumption (e.g. sharing of misinformation)', 'Social networks']",3,2,9,"I don't know what the rule set is, but I believe that ethical approval involves submitting the plan and assuring that it meets the rules, or guidelines, of the institution that would sponsor the study.",Somewhat acceptable,"it feels wrong to use people for a study, when they haven't agreed to take part at the same time, i can understand why it is done the user did post a public comment, so i think they really waived any right that they may have had to keep their opinion private","i don't think that it matters who is conducting the study, or what they hope to achieve, because the result will be the same for the social media user, regardless of those factors",Somewhat unacceptable,"i understand that this is an important study, but i think that sending these social media users private messages, that are not viewable by the public, is too unethical the user does not know that they are part of a study, and taking information that was obtained after a private interaction with the user is too unethical, in my opinion",,Completely acceptable,"i don't think that there is any ethical concern on this study, because everyone knows that they are involved",,Somewhat acceptable,"it is troubling that the social media users did not know that they were being targeted as participants in a study i do understand though, that the study is important and that there may be no other way to efficiently conduct the research",,Very important,Slightly important,Extremely important,Moderately important,Very important,Extremely important,Extremely important,Extremely important,Extremely important,i can't think of any other aspects of research that would be important to my level of concern,5.0,6.0,7.0,2.0,1.0,3.0,4.0,,,,,,
210,True,566.0,Facebook,50.0,Male,White / Caucasian,Highschool,Slightly conservative,Very aware,"['… are large and can contain millions of data points', '… are readily accessible to researchers and easy to collect']","['Creating fake accounts (""bots"")', 'Secretly changing the content of what users see']","['Political elections (e.g. voting behavior)', 'Presidential approval ratings', 'Health topics (e.g. spread of diseases)', 'Communication (e.g. spread of opinions and hate-speech)', 'Public sentiment (e.g. environment-related concerns)', 'News consumption (e.g. sharing of misinformation)', 'Social networks']",0,0,7,Ethical approval is the process of obtaining approval to apply data that is collected by someone other than the researcher.,Completely acceptable,,,Completely acceptable,,,Completely acceptable,,,Somewhat acceptable,,,Extremely important,Not at all important,Not at all important,Moderately important,Not at all important,Very important,Extremely important,Extremely important,Not at all important,"no, i find it perfectly acceptable because you allow data collected by social media to be used just by signing up",6.0,7.0,4.0,5.0,1.0,2.0,3.0,,,,,,
211,True,938.0,Reddit,35.0,Male,Mixed race,Bachelor's degree,Neutral/ Neither conservative or liberal,Not at all aware,"['… are large and can contain millions of data points', '… reflect events in real-time and can be collected continuously over time', '… are naturalistic in that they do not require researchers to directly interact with research volunteers', '… are readily accessible to researchers and easy to collect']","[""Publicly posting on users' profiles"", 'Creating fake accounts (""bots"")']","['Political elections (e.g. voting behavior)', 'Presidential approval ratings', 'Health topics (e.g. spread of diseases)', 'Well-being and economic satisfaction', 'Communication (e.g. spread of opinions and hate-speech)', 'Public sentiment (e.g. environment-related concerns)', 'News consumption (e.g. sharing of misinformation)', 'Social networks']",2,2,8,Ethical approval means that the study will not cause harm to the participants of the study,Neutral,,was there a debrief for participants at the end of the study?  was user data anonymized?,Neutral,the sending of unsolicited messages can be a concern,participant anonymitydata storage could influence how ethically acceptable i find it,Completely acceptable,,,Somewhat unacceptable,"using bot accounts to ""correct"" posts made by users",whether or not a debrief was sent out to targeted users afterward,Slightly important,Not at all important,Not at all important,Slightly important,Moderately important,Moderately important,Slightly important,Slightly important,Slightly important,,5.0,4.0,7.0,3.0,1.0,6.0,2.0,,,,,,
212,True,371.0,Twitter,23.0,Prefer not to say,Asian - Eastern,Bachelor's degree,Slightly liberal,Slightly aware,"['… are large and can contain millions of data points', '… reflect events in real-time and can be collected continuously over time', '… are naturalistic in that they do not require researchers to directly interact with research volunteers', '… are readily accessible to researchers and easy to collect']","['Privately messaging users', 'Creating fake accounts (""bots"")']","['Political elections (e.g. voting behavior)', 'Communication (e.g. spread of opinions and hate-speech)', 'Public sentiment (e.g. environment-related concerns)', 'News consumption (e.g. sharing of misinformation)', 'Social networks']",2,2,5,"Making sure the research is moral, doesn't break social norms, respects people's rights and privacy",Completely acceptable,,make them aware they were part of a research study,Completely acceptable,,,Somewhat acceptable,the installation could be a safety breach,,Completely acceptable,,always let them know they're part of a study,Moderately important,Very important,Very important,Slightly important,Moderately important,Very important,Extremely important,Extremely important,Slightly important,,7.0,2.0,1.0,4.0,5.0,6.0,3.0,,2.0,,,,
213,True,1167.0,Reddit,55.0,Female,White / Caucasian,Bachelor's degree,Slightly conservative,Slightly aware,"['… reflect events in real-time and can be collected continuously over time', '… are naturalistic in that they do not require researchers to directly interact with research volunteers', '… are always representative of people’s offline behavior']",['Privately messaging users'],"['Political elections (e.g. voting behavior)', 'Economic forecasting', 'Presidential approval ratings', 'Communication (e.g. spread of opinions and hate-speech)']",1,1,4,A promise or agreement to not abuse or misuse any data that they may collect,Completely acceptable,i felt that it totally acceptable,,Somewhat unacceptable,i feel like it was very unethical to share publically information that was sent privately,,Somewhat acceptable,,,Somewhat unacceptable,you should not do this without permission,,Very important,Moderately important,Very important,Moderately important,Very important,Extremely important,Extremely important,Very important,Very important,privacy is the important factor,7.0,1.0,6.0,2.0,5.0,4.0,3.0,,,,,,
214,True,947.0,Reddit,38.0,Male,White / Caucasian,Bachelor's degree,Neutral/ Neither conservative or liberal,Slightly aware,"['… are large and can contain millions of data points', '… often capture social relationships not found using traditional methods (e.g. surveys)', '… are readily accessible to researchers and easy to collect']","['Privately messaging users', ""Publicly posting on users' profiles"", 'Creating fake accounts (""bots"")']","['Political elections (e.g. voting behavior)', 'Economic forecasting', 'Presidential approval ratings', 'Health topics (e.g. spread of diseases)', 'Well-being and economic satisfaction', 'Communication (e.g. spread of opinions and hate-speech)', 'Public sentiment (e.g. environment-related concerns)', 'News consumption (e.g. sharing of misinformation)', 'Social networks']",1,3,9,Don't do anything bad,Somewhat acceptable,,,Somewhat unacceptable,,,Somewhat acceptable,am a bit concerned about incentives,,Somewhat acceptable,,,Moderately important,Moderately important,Slightly important,Slightly important,Moderately important,Very important,Moderately important,Moderately important,Moderately important,,3.0,2.0,1.0,5.0,4.0,6.0,7.0,,,,,,
215,True,690.0,Facebook,37.0,Non-binary / third gender,Mixed race,Master's degree or above,Very liberal,Extremely aware,"['… are large and can contain millions of data points', '… reflect events in real-time and can be collected continuously over time', '… are naturalistic in that they do not require researchers to directly interact with research volunteers', '… often capture social relationships not found using traditional methods (e.g. surveys)', '… are readily accessible to researchers and easy to collect']","['Privately messaging users', ""Publicly posting on users' profiles"", 'Creating fake accounts (""bots"")']","['Political elections (e.g. voting behavior)', 'Economic forecasting', 'Presidential approval ratings', 'Health topics (e.g. spread of diseases)', 'Well-being and economic satisfaction', 'Communication (e.g. spread of opinions and hate-speech)', 'Public sentiment (e.g. environment-related concerns)', 'News consumption (e.g. sharing of misinformation)', 'Social networks']",3,3,9,Showing that their studies will do no harm,Completely acceptable,,,Completely acceptable,"this is a pretty cool experiment ,i find nothing unethical",,Somewhat acceptable,"i feel the survey participants should have automatically been offered the survey results, not be required to choose between pay or the results!",,Completely acceptable,,,Slightly important,Very important,Slightly important,Very important,Not at all important,Extremely important,Slightly important,Slightly important,Moderately important,,7.0,1.0,6.0,4.0,2.0,3.0,5.0,,,,,,
216,True,758.0,Reddit,26.0,Male,White / Caucasian,Highschool,Slightly liberal,Slightly aware,"['… are large and can contain millions of data points', '… reflect events in real-time and can be collected continuously over time', '… are naturalistic in that they do not require researchers to directly interact with research volunteers', '… often capture social relationships not found using traditional methods (e.g. surveys)', '… are readily accessible to researchers and easy to collect']","['Creating fake accounts (""bots"")']","['Political elections (e.g. voting behavior)', 'Economic forecasting', 'Presidential approval ratings', 'Health topics (e.g. spread of diseases)', 'Well-being and economic satisfaction', 'Communication (e.g. spread of opinions and hate-speech)', 'Public sentiment (e.g. environment-related concerns)', 'News consumption (e.g. sharing of misinformation)', 'Social networks']",3,1,9,Making sure the experiment does not violate the rights of the people studied.,Somewhat acceptable,,,Somewhat acceptable,,,Completely acceptable,,,Somewhat acceptable,,,Slightly important,Moderately important,Slightly important,Very important,Slightly important,Moderately important,Moderately important,Slightly important,Very important,,3.0,5.0,4.0,2.0,1.0,7.0,6.0,,,,,,
217,True,1180.0,Facebook,40.0,Female,White / Caucasian,Bachelor's degree,Slightly liberal,Very aware,"['… are large and can contain millions of data points', '… reflect events in real-time and can be collected continuously over time', '… are naturalistic in that they do not require researchers to directly interact with research volunteers', '… often capture social relationships not found using traditional methods (e.g. surveys)', '… are readily accessible to researchers and easy to collect']",['Privately messaging users'],"['Political elections (e.g. voting behavior)', 'Economic forecasting', 'Presidential approval ratings', 'Health topics (e.g. spread of diseases)', 'Well-being and economic satisfaction', 'Communication (e.g. spread of opinions and hate-speech)', 'Public sentiment (e.g. environment-related concerns)', 'News consumption (e.g. sharing of misinformation)', 'Social networks']",3,1,9,"I would think it means permission from users to be able to view, analyze, and collect their data.",Somewhat unacceptable,participants were not aware they were part of a research study  that pretty much sums it up,i am sure there is a way to conduct research like this while being more transparent,Completely unacceptable,then the researchers created human-operated anonymous twitter accounts to send each of the identified users an unsolicited private message  highly unethical,how many of those users are bots?  that will definitely skew the numbers,Somewhat acceptable,"access to user's browser history even with permission seems a bit sketchy, although i myself have participated in these kinds of studies",as long as their is a legal agreement to protect their data and users accept then i suppose it is okay,Completely unacceptable,""" then the researchers created automated, human-looking accounts that automatically publicly replied to the posts of users by stating that the tweet might not be true and providing a link to a fact-checking website""creating bot accounts to interact with users seems highly unethical",,Extremely important,Not at all important,Slightly important,Not at all important,Very important,Very important,Extremely important,Moderately important,Extremely important,how many user accounts were actually real human accounts and not bot accounts or accounts used to spread misinformation?,5.0,1.0,6.0,2.0,3.0,7.0,4.0,,,,,,
218,True,667.0,Facebook,56.0,Female,White / Caucasian,Master's degree or above,Very liberal,Very aware,"['… are large and can contain millions of data points', '… reflect events in real-time and can be collected continuously over time', '… often capture social relationships not found using traditional methods (e.g. surveys)', '… are readily accessible to researchers and easy to collect']","['Privately messaging users', ""Publicly posting on users' profiles""]","['Political elections (e.g. voting behavior)', 'Economic forecasting', 'Presidential approval ratings', 'Health topics (e.g. spread of diseases)', 'Well-being and economic satisfaction', 'Communication (e.g. spread of opinions and hate-speech)', 'Public sentiment (e.g. environment-related concerns)', 'News consumption (e.g. sharing of misinformation)', 'Social networks']",2,2,9,that the research methodology meets the ethical standards set forth by the institution.,Somewhat unacceptable,"i wonder what constitutes ""hate speech"" that seems subjective  the participants did not agree to be in the study",,Somewhat unacceptable,they participants did not consent to being in the study,,Completely acceptable,,,Somewhat unacceptable,the participants did not volunteer  they did not know they were part of a study,,Extremely important,Very important,Extremely important,Moderately important,Moderately important,Very important,Extremely important,Extremely important,Very important,,6.0,2.0,3.0,4.0,1.0,7.0,5.0,,,,,,
219,True,356.0,Reddit,29.0,Male,White / Caucasian,Highschool,Very liberal,Moderately aware,"['… are naturalistic in that they do not require researchers to directly interact with research volunteers', '… are readily accessible to researchers and easy to collect']","[""Publicly posting on users' profiles"", 'Creating fake accounts (""bots"")']","['Economic forecasting', 'Presidential approval ratings', 'Health topics (e.g. spread of diseases)', 'Communication (e.g. spread of opinions and hate-speech)', 'Public sentiment (e.g. environment-related concerns)']",0,2,5,It has to be approved by the IRB to show that there are no risks involved with the study,Neutral,,,Neutral,,,Completely unacceptable,this feels way too intrusive into peoples surfing habits,,Neutral,,,Extremely important,Not at all important,Slightly important,Slightly important,Slightly important,Very important,Slightly important,Moderately important,Slightly important,,4.0,3.0,6.0,2.0,1.0,7.0,5.0,,10.0,,,,
220,True,1760.0,Facebook,68.0,Female,White / Caucasian,Bachelor's degree,Slightly liberal,Slightly aware,"['… are large and can contain millions of data points', '… reflect events in real-time and can be collected continuously over time', '… are naturalistic in that they do not require researchers to directly interact with research volunteers', '… often capture social relationships not found using traditional methods (e.g. surveys)', '… are readily accessible to researchers and easy to collect']",['None of the above'],"['Political elections (e.g. voting behavior)', 'Economic forecasting', 'Presidential approval ratings', 'Health topics (e.g. spread of diseases)', 'Well-being and economic satisfaction', 'Communication (e.g. spread of opinions and hate-speech)', 'Public sentiment (e.g. environment-related concerns)', 'News consumption (e.g. sharing of misinformation)', 'Social networks']",3,0,9,They must get approval to ensure that participants are not made uncomfortable or treated in a way that is inappropriate in any way.,Completely acceptable,i see nothing wrong with people receiving messages that respond to hate speech perhaps some good can come of it,,Completely acceptable,i don't see a problem  they were simply sent a private message  they were under no obligation to respond,,Completely acceptable,the study was completely transparent to the participants which makes it completely acceptable,,Completely acceptable,the participants were receiving true information  i think it was a public service to do this as a way of stopping the spread of misinformation and educating those that spread it,,Not at all important,Slightly important,Not at all important,Not at all important,Not at all important,Not at all important,Not at all important,Not at all important,Not at all important,i don't believe the researchers should be using any false information or hate speech or coerce the participants to do anything they are not comfortable with,6.0,7.0,4.0,3.0,1.0,5.0,2.0,,,,,,
221,True,705.0,Facebook,65.0,Female,White / Caucasian,Bachelor's degree,Very liberal,Not at all aware,"['… are naturalistic in that they do not require researchers to directly interact with research volunteers', '… often capture social relationships not found using traditional methods (e.g. surveys)', '… are readily accessible to researchers and easy to collect']",['None of the above'],"['Public sentiment (e.g. environment-related concerns)', 'News consumption (e.g. sharing of misinformation)', 'Social networks']",1,0,3,It means to disclose the purpose of the research being done to participants.,Completely unacceptable,"""participants were not aware they were part of a research study"" which means the study is not ethical",if the research was disclosed to participants,Completely unacceptable,,,Neutral,,,Completely unacceptable,"seems so manipulitive participants chosen had no idea, plus bots were used instead of humans",,Very important,Not at all important,Very important,Not at all important,Very important,Very important,Very important,Not at all important,Moderately important,"social media isn't quite real life, is it?",7.0,4.0,6.0,2.0,1.0,3.0,5.0,,,,,,
222,True,279.0,Facebook,37.0,Female,White / Caucasian,Bachelor's degree,Neutral/ Neither conservative or liberal,Extremely aware,"['… reflect events in real-time and can be collected continuously over time', '… are readily accessible to researchers and easy to collect']",['None of the above'],"['Economic forecasting', 'Health topics (e.g. spread of diseases)', 'Communication (e.g. spread of opinions and hate-speech)']",0,0,3,It is trying to seek approval for things that are morally right.,Completely acceptable,,,Completely acceptable,,,Completely unacceptable,,,Completely unacceptable,,,Extremely important,Extremely important,Extremely important,Extremely important,Extremely important,Extremely important,Extremely important,Extremely important,Extremely important,,6.0,3.0,2.0,5.0,7.0,1.0,4.0,,,,,,
223,True,559.0,Reddit,22.0,Male,White / Caucasian,Highschool,Neutral/ Neither conservative or liberal,Very aware,"['… often capture social relationships not found using traditional methods (e.g. surveys)', '… are readily accessible to researchers and easy to collect']",['Privately messaging users'],"['Political elections (e.g. voting behavior)', 'Economic forecasting', 'Presidential approval ratings', 'Communication (e.g. spread of opinions and hate-speech)', 'Public sentiment (e.g. environment-related concerns)', 'News consumption (e.g. sharing of misinformation)', 'Social networks']",0,1,7,they need to get permission to collect the data ,Completely acceptable,,,Somewhat unacceptable,they should have told them it was for a research study,,Completely acceptable,,,Completely acceptable,,,Not at all important,Not at all important,Not at all important,Not at all important,Slightly important,Moderately important,Very important,Moderately important,Not at all important,,6.0,2.0,7.0,4.0,1.0,5.0,3.0,,,,,,
224,True,2035.0,Facebook,38.0,Non-binary / third gender,Mixed race,Bachelor's degree,Very liberal,Extremely aware,"['… are large and can contain millions of data points', '… reflect events in real-time and can be collected continuously over time', '… are naturalistic in that they do not require researchers to directly interact with research volunteers', '… often capture social relationships not found using traditional methods (e.g. surveys)', '… are readily accessible to researchers and easy to collect']","['Privately messaging users', ""Publicly posting on users' profiles"", 'Creating fake accounts (""bots"")', 'Secretly changing the content of what users see']","['Political elections (e.g. voting behavior)', 'Presidential approval ratings', 'Well-being and economic satisfaction', 'Communication (e.g. spread of opinions and hate-speech)', 'Public sentiment (e.g. environment-related concerns)', 'News consumption (e.g. sharing of misinformation)', 'Social networks']",3,2,7,"I think that it involves pitching the idea of the research to a panel and getting their feedback, and ultimately, approval, to proceed. Ethical approval would be something along the lines of being sure it wasn't manipulative in a harmful way or would result directly in harm (like bullying).",Completely acceptable,,,Completely acceptable,,,Completely acceptable,,,Somewhat acceptable,,"if the bot was clear it was a bot, i guess i would feel better about the acceptability",Extremely important,Extremely important,Moderately important,Very important,Extremely important,Extremely important,Extremely important,Extremely important,Very important,,7.0,5.0,6.0,2.0,1.0,3.0,4.0,,,,,,
225,True,479.0,Facebook,37.0,Male,Mixed race,Bachelor's degree,Slightly conservative,Extremely aware,"['… are large and can contain millions of data points', '… are readily accessible to researchers and easy to collect']",['None of the above'],"['Economic forecasting', 'Presidential approval ratings', 'Health topics (e.g. spread of diseases)', 'Well-being and economic satisfaction', 'Communication (e.g. spread of opinions and hate-speech)', 'Public sentiment (e.g. environment-related concerns)', 'News consumption (e.g. sharing of misinformation)', 'Social networks']",0,0,8,"That the information has been received and will be used in a manner that isn't against any one thing, unbiased. The worst thing to have is information that was obtained through unethical means and ruins the data.",Somewhat unacceptable,"people should be called out when they are broadcasting hate speech, so i don't have any qualms with the merits of the study",,Somewhat unacceptable,identifying users and sending them a private message is questionable because they are targeted,,Completely unacceptable,browser extensions are always a bad thing and it's important to be able to see what information can be shared or viewed by installing them,,Completely unacceptable,seems like a bait and switch to get people to click on the link for those users they know are being targeted,,Extremely important,Extremely important,Extremely important,Extremely important,Moderately important,Slightly important,Moderately important,Slightly important,Very important,i think transparency goes a long way in getting good results i understand it may create a bias because then they know that they are part of the study or that there is a study being done,7.0,2.0,1.0,6.0,5.0,4.0,3.0,,,,,,
226,True,1109.0,Twitter,32.0,Male,African-American,Bachelor's degree,Slightly liberal,Slightly aware,"['… are large and can contain millions of data points', '… reflect events in real-time and can be collected continuously over time', '… are naturalistic in that they do not require researchers to directly interact with research volunteers', '… often capture social relationships not found using traditional methods (e.g. surveys)', '… are readily accessible to researchers and easy to collect', '… are always representative of people’s offline behavior']","['Privately messaging users', 'Creating fake accounts (""bots"")']","['Political elections (e.g. voting behavior)', 'Economic forecasting', 'Presidential approval ratings', 'Health topics (e.g. spread of diseases)', 'Well-being and economic satisfaction', 'Communication (e.g. spread of opinions and hate-speech)', 'Public sentiment (e.g. environment-related concerns)', 'News consumption (e.g. sharing of misinformation)', 'Social networks']",2,2,9,I think ethical approval means getting permission from the people that they are researching based on ethical standards of a research study.,Neutral,"again, the researcher used information without alerting the participants",,Neutral,they did not get approval from the participants,,Somewhat acceptable,,,Neutral,my only concern was that participants were not notified of the study,,Moderately important,Very important,Very important,Very important,Moderately important,Moderately important,Extremely important,Very important,Very important,,7.0,3.0,6.0,1.0,2.0,5.0,4.0,,,,,,
227,True,499.0,Facebook,59.0,Female,White / Caucasian,Highschool,Slightly liberal,Slightly aware,"['… reflect events in real-time and can be collected continuously over time', '… are readily accessible to researchers and easy to collect']",['None of the above'],"['Political elections (e.g. voting behavior)', 'Economic forecasting', 'Presidential approval ratings', 'Health topics (e.g. spread of diseases)', 'Well-being and economic satisfaction', 'Communication (e.g. spread of opinions and hate-speech)', 'Public sentiment (e.g. environment-related concerns)', 'News consumption (e.g. sharing of misinformation)', 'Social networks']",0,0,9,It means getting your written approval ahead of time.,Somewhat acceptable,,,Somewhat unacceptable,,,Completely acceptable,"they were paid and informed, so i think that is acceptable",,Somewhat unacceptable,this is misleading because they were not informed,,Very important,Moderately important,Extremely important,Moderately important,Very important,Extremely important,Extremely important,Very important,Very important,its concerning that people can be mislead and manipulated by some research,7.0,1.0,5.0,2.0,3.0,6.0,4.0,,,,,,
228,True,444.0,Facebook,64.0,Male,White / Caucasian,Master's degree or above,Very liberal,Extremely aware,"['… are large and can contain millions of data points', '… reflect events in real-time and can be collected continuously over time', '… are naturalistic in that they do not require researchers to directly interact with research volunteers', '… often capture social relationships not found using traditional methods (e.g. surveys)', '… are readily accessible to researchers and easy to collect', '… are well formatted and never contain any missing data']","['Privately messaging users', ""Publicly posting on users' profiles"", 'Creating fake accounts (""bots"")']","['Political elections (e.g. voting behavior)', 'Economic forecasting', 'Presidential approval ratings', 'Health topics (e.g. spread of diseases)', 'Well-being and economic satisfaction', 'Communication (e.g. spread of opinions and hate-speech)', 'Public sentiment (e.g. environment-related concerns)', 'News consumption (e.g. sharing of misinformation)', 'Social networks']",2,3,9,"I'm the chair of my institution's IRB, so I know what ethical means. It means protecting the rights and welfare of research participants.",Completely acceptable,"they are changing behavior of participant, not simply measuring behavior",,Completely acceptable,,,Completely acceptable,,,Somewhat acceptable,"again, they are changing behavior, not just measuring it",,Very important,Not at all important,Very important,Not at all important,Very important,Very important,Very important,Very important,Very important,,7.0,6.0,3.0,4.0,2.0,1.0,5.0,,,,,,
229,True,684.0,Reddit,31.0,Male,Mixed race,Master's degree or above,Neutral/ Neither conservative or liberal,Extremely aware,"['… are large and can contain millions of data points', '… reflect events in real-time and can be collected continuously over time', '… are naturalistic in that they do not require researchers to directly interact with research volunteers', '… are readily accessible to researchers and easy to collect']","['Creating fake accounts (""bots"")']","['Political elections (e.g. voting behavior)', 'Presidential approval ratings', 'Health topics (e.g. spread of diseases)', 'Well-being and economic satisfaction', 'Communication (e.g. spread of opinions and hate-speech)', 'Public sentiment (e.g. environment-related concerns)', 'News consumption (e.g. sharing of misinformation)', 'Social networks']",2,1,8,Ethical approval means that the governing institution decides that the research follows a set of pre-decided guidelines so that the research will not sufficiently impact or harm the subjects of the research.,Completely acceptable,,,Somewhat acceptable,"i just hope the people involved were not publicly referenced and were anonymized, especially on twitter",,Completely acceptable,the participants were informed and understood their role in the research this seems completely fair,,Somewhat acceptable,,,Moderately important,Moderately important,Very important,Slightly important,Extremely important,Slightly important,Extremely important,Slightly important,Very important,,5.0,1.0,4.0,2.0,3.0,7.0,6.0,,,,,,
230,True,362.0,Facebook,23.0,Male,White / Caucasian,Some college,Slightly conservative,Moderately aware,"['… reflect events in real-time and can be collected continuously over time', '… are naturalistic in that they do not require researchers to directly interact with research volunteers']","['Privately messaging users', ""Publicly posting on users' profiles"", ""Hacking into users' accounts""]","['Political elections (e.g. voting behavior)', 'Economic forecasting', 'Health topics (e.g. spread of diseases)', 'Well-being and economic satisfaction']",2,1,4,I think ethical approval means that academic researchers need public approval and a public positive opinion to run their experiments.,Somewhat acceptable,i feel this is positive research,,Neutral,,,Completely acceptable,i think it's fine i don't see an issue with it it's based on the decision of a person,,Neutral,,,Very important,Slightly important,Very important,Extremely important,Slightly important,Not at all important,Very important,Extremely important,Slightly important,,6.0,1.0,3.0,2.0,4.0,7.0,5.0,,,,,,
231,True,726.0,Facebook,46.0,Female,White / Caucasian,Bachelor's degree,Slightly liberal,Very aware,"['… are naturalistic in that they do not require researchers to directly interact with research volunteers', '… are readily accessible to researchers and easy to collect']","[""Publicly posting on users' profiles"", 'Creating fake accounts (""bots"")', 'Secretly changing the content of what users see']","['Political elections (e.g. voting behavior)', 'Economic forecasting', 'Presidential approval ratings', 'Health topics (e.g. spread of diseases)', 'Well-being and economic satisfaction', 'Communication (e.g. spread of opinions and hate-speech)', 'Public sentiment (e.g. environment-related concerns)', 'News consumption (e.g. sharing of misinformation)']",0,1,8,"There is an ethics advisory board that must approve their experiments, and these board members make sure that they are not doing anything that could be construed as immoral, unethical or illegal, or influence the experiment in any way.",Neutral,i would need to know more about what the researchers posted in their reply,,Completely acceptable,,,Completely acceptable,,,Completely acceptable,,,Extremely important,Extremely important,Moderately important,Not at all important,Very important,Extremely important,Moderately important,Extremely important,Very important,"how long is the information kept, because it would become irrelevant as politics and types of social media and technology change",3.0,6.0,5.0,1.0,2.0,7.0,4.0,,,,,,
232,True,231.0,Reddit,62.0,Male,White / Caucasian,Bachelor's degree,Very liberal,Not at all aware,['None of the above'],['None of the above'],['None of the above'],0,0,0,I have no idea what it means,Completely unacceptable,,,Completely unacceptable,,,Completely unacceptable,,,Completely unacceptable,,,Extremely important,Extremely important,Extremely important,Extremely important,Extremely important,Extremely important,Extremely important,Extremely important,Extremely important,,5.0,1.0,6.0,2.0,4.0,7.0,3.0,,,,,,
233,True,589.0,Facebook,25.0,Female,White / Caucasian,Bachelor's degree,Neutral/ Neither conservative or liberal,Slightly aware,"['… are large and can contain millions of data points', '… reflect events in real-time and can be collected continuously over time', '… are readily accessible to researchers and easy to collect']","['Creating fake accounts (""bots"")', 'Secretly changing the content of what users see']","['Political elections (e.g. voting behavior)', 'Economic forecasting', 'Presidential approval ratings', 'Health topics (e.g. spread of diseases)', 'Well-being and economic satisfaction', 'Communication (e.g. spread of opinions and hate-speech)', 'Public sentiment (e.g. environment-related concerns)', 'News consumption (e.g. sharing of misinformation)', 'Social networks']",1,0,9,"I don't think the data can be accessed for free and without the participants knowing, so I think ethical approval is making sure participants know who has access to their data and what they are doing with it.",Somewhat unacceptable,participants were unaware that they were a part of a study,,Somewhat unacceptable,participants were unaware they were part of a study,,Completely acceptable,,,Somewhat unacceptable,participants were unaware they were part of a study,people have the right to know how their data is being used,Very important,Moderately important,Very important,Very important,Very important,Very important,Extremely important,Very important,Extremely important,i am mainly concerned about how why my data is being collected and how long it is being stored for,7.0,3.0,4.0,2.0,5.0,6.0,1.0,,,,,,
234,True,1020.0,Twitter,37.0,Male,African-American,Highschool,Neutral/ Neither conservative or liberal,Very aware,"['… are large and can contain millions of data points', '… reflect events in real-time and can be collected continuously over time', '… are naturalistic in that they do not require researchers to directly interact with research volunteers', '… often capture social relationships not found using traditional methods (e.g. surveys)', '… are readily accessible to researchers and easy to collect', '… are always representative of people’s offline behavior', '… are unaffected by the way social media platforms work', '… are well formatted and never contain any missing data']","['Privately messaging users', ""Publicly posting on users' profiles"", 'Creating fake accounts (""bots"")']","['Political elections (e.g. voting behavior)', 'Economic forecasting', 'Presidential approval ratings', 'Health topics (e.g. spread of diseases)', 'Well-being and economic satisfaction', 'Communication (e.g. spread of opinions and hate-speech)', 'Public sentiment (e.g. environment-related concerns)', 'News consumption (e.g. sharing of misinformation)', 'Social networks']",0,3,9,Things or actions that need to be moral and have good ethics.,Somewhat acceptable,"even though the participants did not know they were part of a research study, it was still a good study to me it was true to what was done in this way",,Completely acceptable,good study overall and for them not to know they took part of the study if they knew i dont think they would of shared higher quality news content,,Somewhat unacceptable,they should have not offered money for this not enough anyway,,Neutral,i mean it is hard to tell on this one i really do not have any concerns or nothing just the increase of partisan,,Extremely important,Extremely important,Extremely important,Extremely important,Extremely important,Extremely important,Extremely important,Extremely important,Extremely important,just watch all the threats and brainwashing out there,7.0,3.0,1.0,5.0,6.0,2.0,4.0,,,,,,
235,True,552.0,Twitter,32.0,Male,African-American,Bachelor's degree,Very liberal,Not at all aware,"['… are large and can contain millions of data points', '… reflect events in real-time and can be collected continuously over time', '… are naturalistic in that they do not require researchers to directly interact with research volunteers', '… are readily accessible to researchers and easy to collect', '… are always representative of people’s offline behavior']","['Privately messaging users', 'Creating fake accounts (""bots"")']","['Political elections (e.g. voting behavior)', 'Economic forecasting', 'Health topics (e.g. spread of diseases)', 'Well-being and economic satisfaction', 'Communication (e.g. spread of opinions and hate-speech)', 'Public sentiment (e.g. environment-related concerns)', 'News consumption (e.g. sharing of misinformation)']",1,2,7,"I think ethical approval means that they must contact their school's ethics board, lay out what they plan to research and the methods they plan on conducting the research, and get an approval based on that information.",Completely acceptable,,,Completely acceptable,,,Somewhat acceptable,i would be concerned on exactly what data was collected by the browser extension,,Neutral,,,Extremely important,Not at all important,Slightly important,Not at all important,Slightly important,Not at all important,Moderately important,Moderately important,Very important,,7.0,6.0,4.0,1.0,2.0,5.0,3.0,,,,,,
236,True,984.0,Facebook,47.0,Female,White / Caucasian,Highschool,Very liberal,Not at all aware,"['… are naturalistic in that they do not require researchers to directly interact with research volunteers', '… are readily accessible to researchers and easy to collect']",['None of the above'],"['Political elections (e.g. voting behavior)', 'Economic forecasting', 'Public sentiment (e.g. environment-related concerns)', 'News consumption (e.g. sharing of misinformation)']",0,0,4,They need to get permission from a higher up to do something,Completely acceptable,,,Neutral,,,Neutral,,,Somewhat acceptable,,,Moderately important,Moderately important,Extremely important,Very important,Moderately important,Moderately important,Very important,Extremely important,Moderately important,nothing they did everything right,4.0,1.0,7.0,3.0,5.0,6.0,2.0,,0.0,,0.0,,0.0
237,True,865.0,Reddit,60.0,Male,White / Caucasian,Bachelor's degree,Neutral/ Neither conservative or liberal,Moderately aware,"['… are large and can contain millions of data points', '… reflect events in real-time and can be collected continuously over time', '… are readily accessible to researchers and easy to collect']","['Privately messaging users', ""Publicly posting on users' profiles"", 'Creating fake accounts (""bots"")', 'Secretly changing the content of what users see']","['Economic forecasting', 'Well-being and economic satisfaction', 'Communication (e.g. spread of opinions and hate-speech)', 'Public sentiment (e.g. environment-related concerns)', 'News consumption (e.g. sharing of misinformation)', 'Social networks']",1,2,6,That the execution of the study will not result in harm to the participants.,Somewhat acceptable,"what was the type of hate speech, who decides what is hate speech?",,Neutral,"""professional"" fact-checkers are paid by someone   believing they do their work without bias is naive",,Somewhat acceptable,full disclosure was done   that is best,i wouldn't give up my privacy to install a browser extension for 5 bucks!,Somewhat acceptable,did the researchers fact check the fact checkers?,whether they routed the fact check to biased fact check sites,Very important,Slightly important,Moderately important,Slightly important,Slightly important,Moderately important,Very important,Very important,Moderately important,"whether the researchers are being funded by organizations that themselves are biased, and wish to manipulate subjects towards their beliefs",5.0,3.0,6.0,4.0,1.0,7.0,2.0,where the money is coming from to fund this research  cui bono,7.0,,,,
238,True,986.0,Reddit,62.0,Female,White / Caucasian,Bachelor's degree,Slightly conservative,Not at all aware,"['… are large and can contain millions of data points', '… are naturalistic in that they do not require researchers to directly interact with research volunteers', '… often capture social relationships not found using traditional methods (e.g. surveys)', '… are readily accessible to researchers and easy to collect']","['Privately messaging users', ""Publicly posting on users' profiles"", 'Creating fake accounts (""bots"")', 'Secretly changing the content of what users see', ""Hacking into users' accounts""]","['Political elections (e.g. voting behavior)', 'Presidential approval ratings', 'Well-being and economic satisfaction', 'Communication (e.g. spread of opinions and hate-speech)', 'News consumption (e.g. sharing of misinformation)', 'Social networks']",2,1,6,Letting people know you want to access their data and to maintain certain standards with their information ,Somewhat acceptable,,,Somewhat acceptable,,,Completely acceptable,,,Completely acceptable,,,Very important,Not at all important,Not at all important,Not at all important,Moderately important,Very important,Not at all important,Very important,Not at all important,,7.0,1.0,4.0,3.0,2.0,5.0,6.0,,,,,,
239,True,662.0,Facebook,40.0,Female,White / Caucasian,Master's degree or above,Slightly liberal,Slightly aware,"['… are large and can contain millions of data points', '… reflect events in real-time and can be collected continuously over time', '… are naturalistic in that they do not require researchers to directly interact with research volunteers', '… often capture social relationships not found using traditional methods (e.g. surveys)', '… are readily accessible to researchers and easy to collect']","['Creating fake accounts (""bots"")', 'Secretly changing the content of what users see']","['Political elections (e.g. voting behavior)', 'Economic forecasting', 'Presidential approval ratings', 'Health topics (e.g. spread of diseases)', 'Well-being and economic satisfaction', 'Communication (e.g. spread of opinions and hate-speech)', 'Public sentiment (e.g. environment-related concerns)', 'News consumption (e.g. sharing of misinformation)', 'Social networks']",3,0,9,Their experiment must not be unethical in that it can't negatively affect people or harm people.,Somewhat acceptable,,,Somewhat acceptable,,,Completely acceptable,,,Somewhat acceptable,,,Very important,Moderately important,Moderately important,Moderately important,Moderately important,Moderately important,Moderately important,Very important,Moderately important,it would be most important to protect people's privacy and not collect share their personal information,7.0,6.0,5.0,3.0,1.0,4.0,2.0,,,,,,
240,True,637.0,Twitter,41.0,Male,White / Caucasian,Master's degree or above,Very liberal,Moderately aware,"['… are large and can contain millions of data points', '… reflect events in real-time and can be collected continuously over time', '… are naturalistic in that they do not require researchers to directly interact with research volunteers', '… often capture social relationships not found using traditional methods (e.g. surveys)', '… are readily accessible to researchers and easy to collect']","['Privately messaging users', 'Creating fake accounts (""bots"")']","['Political elections (e.g. voting behavior)', 'Economic forecasting', 'Communication (e.g. spread of opinions and hate-speech)', 'Public sentiment (e.g. environment-related concerns)', 'News consumption (e.g. sharing of misinformation)']",3,2,5,Acceptance that their studies are conducted in a moral manner.,Somewhat unacceptable,,,Somewhat unacceptable,,,Somewhat unacceptable,study results should be available to all participants,,Somewhat unacceptable,,,Slightly important,Not at all important,Slightly important,Slightly important,Moderately important,Moderately important,Extremely important,Slightly important,Slightly important,None,7.0,1.0,4.0,5.0,2.0,6.0,3.0,,,,,,
241,True,980.0,Twitter,31.0,Male,African-American,Master's degree or above,Very liberal,Very aware,"['… are large and can contain millions of data points', '… reflect events in real-time and can be collected continuously over time', '… are naturalistic in that they do not require researchers to directly interact with research volunteers', '… often capture social relationships not found using traditional methods (e.g. surveys)', '… are readily accessible to researchers and easy to collect', '… are always representative of people’s offline behavior']","['Privately messaging users', 'Creating fake accounts (""bots"")']","['Political elections (e.g. voting behavior)', 'Economic forecasting', 'Presidential approval ratings', 'Health topics (e.g. spread of diseases)', 'Well-being and economic satisfaction', 'Communication (e.g. spread of opinions and hate-speech)', 'Public sentiment (e.g. environment-related concerns)', 'Social networks']",2,2,8,it indicates that the researcher is adhering to the accepted ethical standards of a genuine research study.,Somewhat acceptable,,,Somewhat acceptable,,,Completely acceptable,,,Somewhat acceptable,,,Extremely important,Very important,Extremely important,Extremely important,Very important,Very important,Extremely important,Extremely important,Very important,None,6.0,1.0,7.0,2.0,3.0,5.0,4.0,,,,,,
242,True,865.0,Facebook,49.0,Male,White / Caucasian,Bachelor's degree,Very liberal,Not at all aware,"['… are large and can contain millions of data points', '… reflect events in real-time and can be collected continuously over time', '… are naturalistic in that they do not require researchers to directly interact with research volunteers', '… often capture social relationships not found using traditional methods (e.g. surveys)', '… are readily accessible to researchers and easy to collect']","['Privately messaging users', ""Publicly posting on users' profiles"", 'Creating fake accounts (""bots"")']","['Political elections (e.g. voting behavior)', 'Economic forecasting', 'Presidential approval ratings', 'Health topics (e.g. spread of diseases)', 'Well-being and economic satisfaction', 'Communication (e.g. spread of opinions and hate-speech)', 'Public sentiment (e.g. environment-related concerns)', 'News consumption (e.g. sharing of misinformation)', 'Social networks']",3,3,9,I think it refers to the boundaries that researchers cannot cross during the course of their studies.  The institution sets those boundaries to protect the public from researchers being too aggressive with their data collection.,Somewhat unacceptable,i would be curious to know what the public reply from the researchers was to the hate speech posters  it sounds like it was an unsupportive message,how aggressive were the unsupportive messages to the users?  were they combative?  did they try to encourage empathy or seeing the issue from another viewpoint?,Neutral,"public posts are fair game, as are whether or not the user responds to a private message",,Completely acceptable,users were aware of what they were signing up for so i don't see any issues with that,"i would want to see how the researchers determined what was a 'news site' vs any other type of site  if the meaning was too general, more data could be collected than the user realized",Somewhat unacceptable,the end result was that it made the participants even more negative,did the phrasing of the fact checking posts seem like it was attacking the original posters?,Extremely important,Slightly important,Moderately important,Not at all important,Not at all important,Very important,Very important,Extremely important,Moderately important,,5.0,2.0,6.0,1.0,3.0,7.0,4.0,,,,,,
243,True,1215.0,Facebook,41.0,Female,White / Caucasian,Highschool,Very liberal,Extremely aware,"['… are large and can contain millions of data points', '… reflect events in real-time and can be collected continuously over time', '… are naturalistic in that they do not require researchers to directly interact with research volunteers', '… often capture social relationships not found using traditional methods (e.g. surveys)', '… are readily accessible to researchers and easy to collect']","['Privately messaging users', ""Publicly posting on users' profiles"", 'Creating fake accounts (""bots"")']","['Political elections (e.g. voting behavior)', 'Economic forecasting', 'Presidential approval ratings', 'Health topics (e.g. spread of diseases)', 'Well-being and economic satisfaction', 'Communication (e.g. spread of opinions and hate-speech)', 'Public sentiment (e.g. environment-related concerns)', 'News consumption (e.g. sharing of misinformation)', 'Social networks']",3,3,9,approval that their research will not cause any harm,Completely acceptable,,,Completely acceptable,,,Completely acceptable,,,Completely acceptable,,,Very important,Slightly important,Moderately important,Slightly important,Extremely important,Very important,Very important,Very important,Extremely important,,7.0,6.0,1.0,5.0,3.0,4.0,2.0,,,,,,
244,True,824.0,Twitter,25.0,Female,White / Caucasian,Bachelor's degree,Slightly liberal,Moderately aware,"['… are large and can contain millions of data points', '… reflect events in real-time and can be collected continuously over time', '… are naturalistic in that they do not require researchers to directly interact with research volunteers', '… often capture social relationships not found using traditional methods (e.g. surveys)']",['None of the above'],"['Political elections (e.g. voting behavior)', 'Economic forecasting', 'Presidential approval ratings', 'Health topics (e.g. spread of diseases)', 'Well-being and economic satisfaction', 'Communication (e.g. spread of opinions and hate-speech)', 'Public sentiment (e.g. environment-related concerns)', 'News consumption (e.g. sharing of misinformation)', 'Social networks']",4,0,9,"Ethical approval involves making sure that the research study does not harm any participants and that ethically, no one would look down on the research, researchers, or participants for what data is being collected or how the data is collected.",Completely unacceptable,participants did not give consent,,Completely unacceptable,participants did not give consent the researchers were sending unsolicited messages,,Somewhat unacceptable,"that the participants were receiving different compensations, and that every participant should have access to the study results and because the participants knew what the research was looking for, their regular behavior changed, skewing the results of the research",,Completely unacceptable,"the researchers were using a level of deception when they created the bot accounts plus, the participants didn't even know they were part of the study, so there was no consent given",,Very important,Moderately important,Very important,Slightly important,Very important,Extremely important,Extremely important,Extremely important,Very important,,7.0,1.0,4.0,3.0,2.0,6.0,5.0,,,,,,
245,True,885.0,Facebook,56.0,Male,White / Caucasian,Master's degree or above,Very liberal,Very aware,"['… are large and can contain millions of data points', '… reflect events in real-time and can be collected continuously over time', '… are naturalistic in that they do not require researchers to directly interact with research volunteers', '… are readily accessible to researchers and easy to collect']","['Creating fake accounts (""bots"")']","['Political elections (e.g. voting behavior)', 'Economic forecasting', 'Presidential approval ratings', 'Health topics (e.g. spread of diseases)', 'Well-being and economic satisfaction', 'Communication (e.g. spread of opinions and hate-speech)', 'Public sentiment (e.g. environment-related concerns)', 'News consumption (e.g. sharing of misinformation)', 'Social networks']",2,1,9,It means that they have to follow ethical standards in obtaining the data and make people informed of what data that is collected is being used for and how it is being used.,Somewhat unacceptable,"the information on twitter was public, however there was deception by the person that posted the comment and no disclosure of how they would use the subsequent information in their research",,Completely unacceptable,"the initial twitter posts were public, but by sending private messages by a human was not acceptable  there was no indication of a research project and this is intentional violation of privacy and trust",,Completely acceptable,"this was clearly spelled out that it was a research survey, offering incentives and people had to take action to be included in the research, so it us clearly acceptable",,Somewhat acceptable,"i think since it was publicly viewable, there is not a real ethical issue with using that information  the user was sharing their tweets so that anyone could see andor reply  there was no expectation of privacy","just the fact that it was publicly shared and anyone could see andor comment on it, so they have no privacy",Extremely important,Slightly important,Slightly important,Moderately important,Moderately important,Extremely important,Very important,Moderately important,Moderately important,,6.0,4.0,7.0,5.0,2.0,3.0,1.0,,,,,,
246,True,1415.0,Facebook,30.0,Male,White / Caucasian,Bachelor's degree,Very liberal,Moderately aware,"['… are large and can contain millions of data points', '… reflect events in real-time and can be collected continuously over time', '… are naturalistic in that they do not require researchers to directly interact with research volunteers', '… often capture social relationships not found using traditional methods (e.g. surveys)', '… are readily accessible to researchers and easy to collect']","['Privately messaging users', ""Publicly posting on users' profiles"", 'Creating fake accounts (""bots"")']","['Political elections (e.g. voting behavior)', 'Economic forecasting', 'Presidential approval ratings', 'Health topics (e.g. spread of diseases)', 'Communication (e.g. spread of opinions and hate-speech)', 'Public sentiment (e.g. environment-related concerns)', 'News consumption (e.g. sharing of misinformation)', 'Social networks']",3,3,8,I think ethical approval means that they get confirmation what they are studying is morally respectable,Somewhat acceptable,,,Somewhat acceptable,,,Completely acceptable,,,Completely acceptable,,,Moderately important,Moderately important,Slightly important,Very important,Very important,Moderately important,Moderately important,Moderately important,Moderately important,,7.0,3.0,1.0,5.0,4.0,2.0,6.0,,,,,,
247,True,763.0,Facebook,52.0,Male,White / Caucasian,Bachelor's degree,Slightly conservative,Very aware,"['… are large and can contain millions of data points', '… reflect events in real-time and can be collected continuously over time', '… are naturalistic in that they do not require researchers to directly interact with research volunteers', '… often capture social relationships not found using traditional methods (e.g. surveys)', '… are readily accessible to researchers and easy to collect']","['Privately messaging users', ""Publicly posting on users' profiles"", 'Creating fake accounts (""bots"")']","['Political elections (e.g. voting behavior)', 'Economic forecasting', 'Presidential approval ratings', 'Health topics (e.g. spread of diseases)', 'Well-being and economic satisfaction', 'Communication (e.g. spread of opinions and hate-speech)', 'Public sentiment (e.g. environment-related concerns)', 'News consumption (e.g. sharing of misinformation)', 'Social networks']",3,3,9,I believe this would represent that the experiment would need to show that it is trying to find some result without bias.  That what they are doing is not going against what society or academia would consider inappropriate.,Somewhat unacceptable,it is just inflaming a situation - not sure what would be accomplished as that is the result those tweets are looking for in the first place,,Somewhat acceptable,,,Completely acceptable,people were aware which is good,,Completely acceptable,i do not think it was wrong as it just provided the alternative view with a link to why they thought this  no inflammatory or provocative responses by the researchers  it is a public forum so,,Moderately important,Extremely important,Very important,Very important,Moderately important,Very important,Very important,Very important,Very important,as long as bias is left out and people are not being instigated without knowledge - i mean pushed for a specific reaction to validate a bias then i am ok with it,1.0,7.0,6.0,3.0,4.0,5.0,2.0,None,4.0,,,,
248,True,475.0,Twitter,43.0,Male,White / Caucasian,Highschool,Slightly conservative,Slightly aware,"['… are large and can contain millions of data points', '… reflect events in real-time and can be collected continuously over time', '… are naturalistic in that they do not require researchers to directly interact with research volunteers', '… often capture social relationships not found using traditional methods (e.g. surveys)']","['Creating fake accounts (""bots"")', 'Secretly changing the content of what users see']",['News consumption (e.g. sharing of misinformation)'],4,0,1,means if what the institution finds there research for is right,Completely acceptable,,,Completely acceptable,,,Somewhat acceptable,,,Completely acceptable,,,Very important,Slightly important,Very important,Slightly important,Slightly important,Extremely important,Moderately important,Slightly important,Very important,,6.0,5.0,3.0,4.0,1.0,2.0,7.0,,,,,,
249,True,777.0,Reddit,46.0,Male,White / Caucasian,Highschool,Very liberal,Not at all aware,"['… are large and can contain millions of data points', '… reflect events in real-time and can be collected continuously over time', '… are naturalistic in that they do not require researchers to directly interact with research volunteers', '… often capture social relationships not found using traditional methods (e.g. surveys)', '… are readily accessible to researchers and easy to collect']","[""Publicly posting on users' profiles"", 'Creating fake accounts (""bots"")']","['Political elections (e.g. voting behavior)', 'Presidential approval ratings', 'Health topics (e.g. spread of diseases)', 'Communication (e.g. spread of opinions and hate-speech)', 'Public sentiment (e.g. environment-related concerns)', 'News consumption (e.g. sharing of misinformation)', 'Social networks']",3,2,7,If what they are doing is morally right,Completely acceptable,,,Completely acceptable,why not also target left leaning accounts? can't misinformation be spread all across the political spectrum? i do recognize the idea that it is mostly spread by right leaning,,Neutral,,some of those sites are not reliable and actively try to influence people,Completely acceptable,,,Not at all important,Not at all important,Not at all important,Not at all important,Not at all important,Moderately important,Slightly important,Slightly important,Not at all important,,3.0,5.0,4.0,2.0,1.0,6.0,7.0,,,,,,
250,True,514.0,Reddit,35.0,Male,White / Caucasian,Bachelor's degree,Very liberal,Moderately aware,"['… are large and can contain millions of data points', '… reflect events in real-time and can be collected continuously over time', '… are readily accessible to researchers and easy to collect']",['None of the above'],"['Political elections (e.g. voting behavior)', 'Presidential approval ratings', 'Well-being and economic satisfaction', 'Public sentiment (e.g. environment-related concerns)']",1,0,4,I believe ethical approval means a set group of people look at proposals and decide if the experiment is focused on the greater good of the participants and society as a whole without the outcomes of injury or harm.,Neutral,not letting participants know they are part of a study is a concern,,Neutral,not giving the participants a chance to consent is one aspect i am unsure about,,Somewhat acceptable,i appreciate that people could opt in to this research,,Neutral,"again, participants were not aware and i find that concerning",,Slightly important,Not at all important,Not at all important,Slightly important,Slightly important,Very important,Extremely important,Not at all important,Moderately important,,7.0,3.0,5.0,4.0,1.0,6.0,2.0,,10.0,,9.0,,8.0
251,True,944.0,Twitter,38.0,Male,White / Caucasian,Bachelor's degree,Slightly conservative,Moderately aware,"['… are large and can contain millions of data points', '… reflect events in real-time and can be collected continuously over time', '… are readily accessible to researchers and easy to collect']","['Privately messaging users', ""Publicly posting on users' profiles"", 'Creating fake accounts (""bots"")']","['Political elections (e.g. voting behavior)', 'Presidential approval ratings', 'Health topics (e.g. spread of diseases)', 'Well-being and economic satisfaction', 'Communication (e.g. spread of opinions and hate-speech)', 'Public sentiment (e.g. environment-related concerns)', 'News consumption (e.g. sharing of misinformation)', 'Social networks']",1,3,8,They have to make sure the experiment will be ethically done.,Somewhat acceptable,,,Somewhat acceptable,that they weren't aware that they are a part of the study but i don't think there is any harm in what the study did,,Somewhat unacceptable,installing a browser extension is very invasive not to mention the participants were hugely underpaid for their data,,Somewhat acceptable,,,Slightly important,Not at all important,Not at all important,Very important,Not at all important,Slightly important,Moderately important,Not at all important,Not at all important,,6.0,5.0,4.0,1.0,3.0,7.0,2.0,,,,,,
252,True,958.0,Facebook,24.0,Female,Hispanic,Associate's degree,Slightly liberal,Moderately aware,"['… reflect events in real-time and can be collected continuously over time', '… are readily accessible to researchers and easy to collect']","['Privately messaging users', 'Creating fake accounts (""bots"")']","['Political elections (e.g. voting behavior)', 'Presidential approval ratings', 'Communication (e.g. spread of opinions and hate-speech)', 'News consumption (e.g. sharing of misinformation)', 'Social networks']",0,2,5,Getting people to agree about what is morally right. ,Somewhat acceptable,,,Somewhat acceptable,,,Somewhat unacceptable,offering money to people makes it bad,,Neutral,,,Slightly important,Slightly important,Very important,Moderately important,Slightly important,Moderately important,Very important,Very important,Slightly important,,7.0,4.0,6.0,2.0,1.0,5.0,3.0,probability of person finding out about the fake scenario,1.0,negative backlash against the project,2.0,inability to continue with the scenario,3.0
253,True,717.0,Reddit,35.0,Male,Asian - Indian,Master's degree or above,Slightly liberal,Moderately aware,"['… are large and can contain millions of data points', '… reflect events in real-time and can be collected continuously over time', '… are naturalistic in that they do not require researchers to directly interact with research volunteers', '… often capture social relationships not found using traditional methods (e.g. surveys)', '… are readily accessible to researchers and easy to collect']",['Privately messaging users'],"['Political elections (e.g. voting behavior)', 'Economic forecasting', 'Health topics (e.g. spread of diseases)', 'Public sentiment (e.g. environment-related concerns)', 'News consumption (e.g. sharing of misinformation)']",3,1,5,I do not know what it means but guessing it contains bot breaking any laws,Completely acceptable,,,Completely acceptable,,,Completely acceptable,,,Completely acceptable,,,Extremely important,Very important,Very important,Moderately important,Not at all important,Moderately important,Slightly important,Very important,Very important,,6.0,7.0,3.0,1.0,4.0,5.0,2.0,,,,,,
254,True,658.0,Facebook,70.0,Female,White / Caucasian,Vocational training,Slightly liberal,Very aware,"['… are large and can contain millions of data points', '… reflect events in real-time and can be collected continuously over time', '… are naturalistic in that they do not require researchers to directly interact with research volunteers', '… often capture social relationships not found using traditional methods (e.g. surveys)', '… are readily accessible to researchers and easy to collect']",['None of the above'],"['Presidential approval ratings', 'Communication (e.g. spread of opinions and hate-speech)', 'Public sentiment (e.g. environment-related concerns)', 'Social networks']",3,0,4,"Before their name is attached to an experiment, they want to make sure it is not offensive or even illegal.",Somewhat acceptable,None,,Completely acceptable,,,Completely acceptable,"this was actually very good to know that people's opinions could be ""tempered down"" when in a situation to consider the opposite view",,Completely acceptable,,,Very important,Very important,Extremely important,Very important,Very important,Very important,Not at all important,Extremely important,Very important,i'm not entirely convinced that social media behavior is a good indication of real world behavior,5.0,7.0,4.0,3.0,2.0,6.0,1.0,,,,,,
255,True,837.0,Reddit,38.0,Male,African-American,Bachelor's degree,Very liberal,Moderately aware,"['… are large and can contain millions of data points', '… reflect events in real-time and can be collected continuously over time', '… often capture social relationships not found using traditional methods (e.g. surveys)', '… are readily accessible to researchers and easy to collect']","['Privately messaging users', 'Creating fake accounts (""bots"")']","['Political elections (e.g. voting behavior)', 'Presidential approval ratings', 'Health topics (e.g. spread of diseases)', 'Well-being and economic satisfaction', 'Communication (e.g. spread of opinions and hate-speech)', 'Public sentiment (e.g. environment-related concerns)', 'News consumption (e.g. sharing of misinformation)', 'Social networks']",2,2,8,The permission of those who run the sites as well as those who use them ,Completely acceptable,,,Completely acceptable,,,Completely acceptable,,,Neutral,"it didn't help with the matter at all in fact, it seems that things may have gotten worse",,Extremely important,Extremely important,Extremely important,Extremely important,Extremely important,Extremely important,Extremely important,Extremely important,Extremely important,,6.0,3.0,7.0,2.0,4.0,5.0,1.0,,,,,,
256,True,715.0,Facebook,76.0,Female,White / Caucasian,Highschool,Slightly liberal,Slightly aware,"['… are large and can contain millions of data points', '… are naturalistic in that they do not require researchers to directly interact with research volunteers', '… often capture social relationships not found using traditional methods (e.g. surveys)', '… are readily accessible to researchers and easy to collect']","['Privately messaging users', ""Publicly posting on users' profiles"", 'Creating fake accounts (""bots"")']","['Political elections (e.g. voting behavior)', 'Economic forecasting', 'Presidential approval ratings', 'Health topics (e.g. spread of diseases)', 'Communication (e.g. spread of opinions and hate-speech)', 'Public sentiment (e.g. environment-related concerns)', 'Social networks']",2,3,7,Ethical approval means that a committee knowledgeable of ethical practices and behaviors reviews the content and purpose of experiment to be sure it does not cross over determined ethical standards set by the institution.,Somewhat unacceptable,,,Somewhat unacceptable,it is ethical to identify yourself so the user knows who they are sharing information with and why,,Somewhat acceptable,,,Somewhat unacceptable,again it is almost like hacking into someone's private space without identifying yourself,,Slightly important,Extremely important,Very important,Very important,Moderately important,Slightly important,Extremely important,Moderately important,Very important,,6.0,1.0,4.0,2.0,5.0,7.0,3.0,,,,,,
257,True,1264.0,Reddit,33.0,Male,White / Caucasian,Highschool,Neutral/ Neither conservative or liberal,Very aware,"['… are large and can contain millions of data points', '… reflect events in real-time and can be collected continuously over time', '… are naturalistic in that they do not require researchers to directly interact with research volunteers', '… often capture social relationships not found using traditional methods (e.g. surveys)']","['Privately messaging users', 'Secretly changing the content of what users see']","['Political elections (e.g. voting behavior)', 'Economic forecasting', 'Presidential approval ratings', 'Health topics (e.g. spread of diseases)', 'Well-being and economic satisfaction', 'Communication (e.g. spread of opinions and hate-speech)', 'Public sentiment (e.g. environment-related concerns)', 'News consumption (e.g. sharing of misinformation)', 'Social networks']",4,0,9,I believe that it means that they will not compromise peoples personal identities. When I say this I mean making sure that they do not compromise information that needs to be kept private such as Driver License and other data that could be used against them if in the wrong hands. ,Somewhat unacceptable,even though i think that this did some good after it was done i feel that it is unethical to group people like that on twitter people get so polarized these if that information that they got grouped into a group that causes hate speech then that could have negative influences and blow back in their personal lives even though i dont think people should use hate speech they kind of have that freedom to do so,i would like to know if the information that was gathered and labeled into a group about hate speech was destroyed by the end of the study,Somewhat unacceptable,this is unethical because i find this really biased why only right-leaning news posts? lets face it at the end of the day people that go to the extreme rather it is on the right or left spread misinformation and both sides need to be brought to light only doing this and demonizing only one side is unethical,,Somewhat acceptable,i do not have a lot of concerns about this because it has been done with the consent of the participants,i would like to know how often people read news articles from the other party or side,Somewhat unacceptable,i feel that people are allowed to think and believe what they want to it does not matter if it is right or wrong at the end of the day because that is a personal freedom that they have i feel that the use of the bot is what makes this unethical because that bot could be coded to only respond to certain political backgrounds and not fact check both sides,i would like to know if it was politically targeted by that i mean did they only follow conservatives or liberals? was it a healthy mixture of both?,Extremely important,Slightly important,Moderately important,Slightly important,Very important,Slightly important,Very important,Slightly important,Extremely important,i feel if one side is looked into then the other needs to be as well neither side is perfect and both sides need to be seen for what they are doing,7.0,3.0,1.0,4.0,5.0,6.0,2.0,,0.0,,0.0,,0.0
258,True,1255.0,Facebook,41.0,Male,White / Caucasian,Bachelor's degree,Neutral/ Neither conservative or liberal,Slightly aware,"['… reflect events in real-time and can be collected continuously over time', '… often capture social relationships not found using traditional methods (e.g. surveys)', '… are readily accessible to researchers and easy to collect']",['None of the above'],"['Political elections (e.g. voting behavior)', 'Economic forecasting', 'Presidential approval ratings', 'Health topics (e.g. spread of diseases)', 'Well-being and economic satisfaction', 'Communication (e.g. spread of opinions and hate-speech)', 'Public sentiment (e.g. environment-related concerns)', 'News consumption (e.g. sharing of misinformation)', 'Social networks']",1,0,9,A guarantee from the researcher that no subject will be harmed or misled as a result of the the research method.,Completely acceptable,,i would like to see some examples of responses sent to the actual twitter users,Completely unacceptable,"if there is direct interaction with someone, that person should be aware they're part of a study",,Completely acceptable,,,Somewhat unacceptable,"since the users were interacted with, they should be informed they're part of a study",,Moderately important,Not at all important,Not at all important,Not at all important,Slightly important,Slightly important,Very important,Moderately important,Not at all important,,7.0,2.0,6.0,3.0,1.0,4.0,5.0,,,,,,
259,True,601.0,Reddit,36.0,Male,White / Caucasian,Highschool,Slightly conservative,Very aware,"['… reflect events in real-time and can be collected continuously over time', '… are readily accessible to researchers and easy to collect']","['Creating fake accounts (""bots"")', 'Secretly changing the content of what users see']","['Political elections (e.g. voting behavior)', 'Public sentiment (e.g. environment-related concerns)', 'News consumption (e.g. sharing of misinformation)', 'Social networks']",0,0,4,I think that ethical approval means getting users to agree to terms of service where they can mine data from them.,Somewhat acceptable,,,Neutral,,,Neutral,,,Somewhat unacceptable,,,Very important,Not at all important,Very important,Slightly important,Very important,Very important,Extremely important,Moderately important,Very important,,5.0,2.0,6.0,3.0,1.0,7.0,4.0,,8.0,,9.0,,10.0
260,True,733.0,Facebook,40.0,Female,White / Caucasian,Bachelor's degree,Neutral/ Neither conservative or liberal,Moderately aware,"['… are naturalistic in that they do not require researchers to directly interact with research volunteers', '… often capture social relationships not found using traditional methods (e.g. surveys)', '… are readily accessible to researchers and easy to collect']","['Creating fake accounts (""bots"")', 'Secretly changing the content of what users see']","['Political elections (e.g. voting behavior)', 'Well-being and economic satisfaction', 'Communication (e.g. spread of opinions and hate-speech)', 'Public sentiment (e.g. environment-related concerns)', 'News consumption (e.g. sharing of misinformation)']",1,0,5,I think that it means truthful acceptance.,Neutral,"i think that there are people labeling things as ""hate speech"" that isn't really hate speech again these people are politically biased",,Neutral,"again, and especially when it says right - leaning, i don't think that things being labeled as misinformation are always actually misinformation the ""fact checkers"" are a lot of the times biased and specifically politically biased",,Somewhat acceptable,"this one, i think is more acceptable, because people knew that they were participaiting",,Neutral,"i believe that people are labeling things as misinformation when it is not a lot of the ""fact checkers"" are politically biased",,Slightly important,Very important,Moderately important,Slightly important,Slightly important,Moderately important,Extremely important,Slightly important,Slightly important,,7.0,2.0,5.0,3.0,1.0,6.0,4.0,,,,,,
261,True,702.0,Twitter,43.0,Male,Asian - Eastern,Bachelor's degree,Slightly conservative,Moderately aware,"['… are large and can contain millions of data points', '… are readily accessible to researchers and easy to collect']","['Privately messaging users', 'Creating fake accounts (""bots"")']","['Political elections (e.g. voting behavior)', 'Presidential approval ratings', 'Communication (e.g. spread of opinions and hate-speech)', 'Public sentiment (e.g. environment-related concerns)', 'News consumption (e.g. sharing of misinformation)']",0,2,5,The consent  for approval genuine research. It just simply an accountability of you content.,Neutral,,,Completely unacceptable,,,Somewhat acceptable,,,Completely unacceptable,,,Very important,Very important,Very important,Very important,Very important,Very important,Very important,Very important,Moderately important,,3.0,2.0,4.0,1.0,5.0,7.0,6.0,,,,,,
262,True,1033.0,Facebook,65.0,Female,White / Caucasian,Bachelor's degree,Slightly liberal,Not at all aware,"['… are naturalistic in that they do not require researchers to directly interact with research volunteers', '… often capture social relationships not found using traditional methods (e.g. surveys)', '… are readily accessible to researchers and easy to collect']","['Creating fake accounts (""bots"")', 'Secretly changing the content of what users see']","['Economic forecasting', 'Presidential approval ratings', 'Health topics (e.g. spread of diseases)', 'Communication (e.g. spread of opinions and hate-speech)', 'Public sentiment (e.g. environment-related concerns)']",1,0,5,"Ethical approval would indicate that the institution housing the academic researchers monitor the experiments to ensure the proper guidelines and privacy laws are followed, with data being kept anonymous towards the people who have their data viewed or used.",Completely acceptable,"i am not sure this served any real purpose as far as investigations  people always respond with more warmth when they are treated with empathy  some people think that means they made their point, while others, only posting hateful posts because they themselves feel so lost and bitter, feel comfort in some kind words it is no solution as the person will still spew vitriol until they get their heads straight",,Somewhat acceptable,private messaging seems a bit more intrusive as it is a method in which hackers have used to engage,,Completely acceptable,"i like this study participants went in with their eyes open, and being forced to ingest information from sites they normally avoided seems to have had a positive effect by showing them that all people have an opinion and if it was truly black and white there would be no need for a two party political system  it sounds as if the experiment took the fear and hatred away","i love this study, very acceptable to me",Completely acceptable,,,Moderately important,Extremely important,Extremely important,Moderately important,Slightly important,Very important,Slightly important,Extremely important,Very important,"if the research is done for truly good reasons and no harm can come to the people being analysed, i think its a wonderful tool  i do this myself with acquaintances in reality  if i see that they have a great deal of hateful and ridiculously crazy conspiracy filled content on their social media i generally tend to distance myself from them",6.0,7.0,4.0,2.0,1.0,5.0,3.0,,,,,,
263,True,709.0,Twitter,31.0,Male,White / Caucasian,Bachelor's degree,Slightly liberal,Slightly aware,"['… are large and can contain millions of data points', '… reflect events in real-time and can be collected continuously over time', '… often capture social relationships not found using traditional methods (e.g. surveys)', '… are readily accessible to researchers and easy to collect']","['Privately messaging users', 'Creating fake accounts (""bots"")']","['Well-being and economic satisfaction', 'Communication (e.g. spread of opinions and hate-speech)', 'Public sentiment (e.g. environment-related concerns)', 'News consumption (e.g. sharing of misinformation)', 'Social networks']",2,2,5,They need to determine whether their experiments are ethical and considered morally sound.,Somewhat acceptable,"if the results of the experiment seem to reduce hate speech and foster empathy, i find it very acceptable",,Somewhat acceptable,"the results lead to people posting more accurate content, which is good",,Neutral,i think the fact that they offered incentives in the form of gift cards probably makes their experiment slightly morally grey,,Somewhat acceptable,i think it's not morally wrong for them to conduct this study,,Moderately important,Moderately important,Moderately important,Very important,Moderately important,Moderately important,Slightly important,Very important,Moderately important,,4.0,2.0,6.0,5.0,1.0,3.0,7.0,,,,,,
264,True,1945.0,Facebook,58.0,Female,White / Caucasian,Bachelor's degree,Slightly conservative,Moderately aware,"['… are large and can contain millions of data points', '… reflect events in real-time and can be collected continuously over time', '… are naturalistic in that they do not require researchers to directly interact with research volunteers', '… often capture social relationships not found using traditional methods (e.g. surveys)', '… are readily accessible to researchers and easy to collect']","[""Publicly posting on users' profiles"", 'Creating fake accounts (""bots"")', 'Secretly changing the content of what users see']","['Political elections (e.g. voting behavior)', 'Economic forecasting', 'Presidential approval ratings', 'Health topics (e.g. spread of diseases)', 'Well-being and economic satisfaction', 'Communication (e.g. spread of opinions and hate-speech)', 'Public sentiment (e.g. environment-related concerns)', 'News consumption (e.g. sharing of misinformation)', 'Social networks']",3,1,9,"Ethical approval would mean that the factors of the research would protect the rights, safety and welfare of both the researcher and the participants.",Completely acceptable,,,Somewhat acceptable,,,Completely acceptable,,,Somewhat acceptable,,,Slightly important,Slightly important,Slightly important,Moderately important,Moderately important,Very important,Slightly important,Slightly important,Very important,,7.0,6.0,4.0,3.0,1.0,5.0,2.0,be mindful of any cultural appropriation in the study,8.0,be mindful of manipulation that could skewer the results you desire,9.0,,
265,True,568.0,Facebook,39.0,Female,White / Caucasian,Master's degree or above,Slightly liberal,Very aware,"['… reflect events in real-time and can be collected continuously over time', '… often capture social relationships not found using traditional methods (e.g. surveys)']","[""Publicly posting on users' profiles"", 'Creating fake accounts (""bots"")', 'Secretly changing the content of what users see']","['Political elections (e.g. voting behavior)', 'Economic forecasting', 'Presidential approval ratings', 'Health topics (e.g. spread of diseases)', 'Well-being and economic satisfaction', 'Communication (e.g. spread of opinions and hate-speech)', 'Public sentiment (e.g. environment-related concerns)', 'News consumption (e.g. sharing of misinformation)', 'Social networks']",2,1,9,Ethical approval would mean that there are no ethical violations in completing the study.,Somewhat unacceptable,the biggest concern i have is that the participants did not complete any sort of informed consent that they were part of the study,i would love to see how the participants were selected - what demographics applied? how was hate speech defined?,Somewhat unacceptable,"i dislike that the participants were not informed, as well as that they received private messages this seems like an ethical violation",,Somewhat acceptable,"i had fewer concerns about this study, as the participants knew they were part of it",i appreciated that the participants were able to choose to get a copy of the results if they wanted,Somewhat unacceptable,i had similar problems with the first study - that the participants did not know that they are part of a research study,,Extremely important,Very important,Extremely important,Moderately important,Moderately important,Extremely important,Extremely important,Extremely important,Extremely important,,7.0,1.0,4.0,3.0,5.0,2.0,6.0,,0.0,,,,
266,True,1680.0,Twitter,70.0,Female,White / Caucasian,Bachelor's degree,Very conservative,Very aware,"['… reflect events in real-time and can be collected continuously over time', '… are naturalistic in that they do not require researchers to directly interact with research volunteers', '… often capture social relationships not found using traditional methods (e.g. surveys)', '… are readily accessible to researchers and easy to collect']","[""Publicly posting on users' profiles"", 'Creating fake accounts (""bots"")']","['Political elections (e.g. voting behavior)', 'Economic forecasting', 'Presidential approval ratings', 'Health topics (e.g. spread of diseases)', 'Well-being and economic satisfaction', 'Communication (e.g. spread of opinions and hate-speech)', 'Public sentiment (e.g. environment-related concerns)', 'News consumption (e.g. sharing of misinformation)']",2,2,8,"It means that the institution they are in says it's OK to use the methods the researcher wants to use to collect the data . Problem there is , Who decides how ethical the institution is ? Most , if not all  "" academic "" institutions , at least in America are wildly left wing.  Their "" ethics "" are all screwed up. ",Somewhat unacceptable,"first of all, what is "" hate speech "" ? again , according to the left , hate speech is anything they don't like  the left engages in hate speech against conservatives and republicans every day like encouraging people to drive republicans out of public places, riot, burn the cities, and assassinate scotus judges  that's all totally fine  but if a conservative says that it's might not be ok to murder your baby in the womb , that's considered hate speech by the left the hypocrisy of the left is so glaring it's an embarrassment , but they don't see it that way do they  again, it's all about intimidation , control and power for the left",,Somewhat acceptable,"this  seems to expose the fact checkers as being horribly biased against conservatives  it's ok the whole term "" misinformation "" is just another term used by the left to censor conservatives  who do they they they are that they can decide what misinformation is ? for them , misinformation is anything they don't like , even if it is factually true they don't care about truth at all they care about power",,Completely acceptable,this seems ok at least the participants knew they were in a research study,,Neutral,"there is so much wrong here first "" fact checkers "" are nothing but far left wing sites that pretend to be fact checking when all they do is censor conservative political content   they are used to manipulate and change peoples opinions and most importantly , their votes","no it's wildly unethical but the whole myth of "" fact checking "" is very unethical too but the left doesn't care it's all about power for the left",Moderately important,Slightly important,Extremely important,Extremely important,Very important,Extremely important,Extremely important,Extremely important,Moderately important,"i am concerned by everything that happens on social  media i am very careful how i use it or if i use it  social media is basically a sewer, used by the left  in their unbridled zeal to destroy america and everyone who disagrees with their hate filled destructive agenda  the real hate has always been on the left , not the right",7.0,2.0,4.0,1.0,5.0,6.0,3.0,"the institution and the researcher should be required to state that they are hard core leftist entities  they should not be able to hide behind the myth of "" objectivity """,1.0,"they should be required to state which political party they make financial contributions to , and how much money they give each year",2.0,,
267,True,947.0,Twitter,33.0,Male,African-American,Bachelor's degree,Very liberal,Very aware,"['… are large and can contain millions of data points', '… reflect events in real-time and can be collected continuously over time']","[""Publicly posting on users' profiles""]","['Health topics (e.g. spread of diseases)', 'Public sentiment (e.g. environment-related concerns)']",2,1,2,This mean obtaining ethical approval the researcher is demonstrating that they have adhered to the accepted ethical standards of a genuine research study. Participants have the right to know who has access to their data and what is being done with it,Somewhat unacceptable,,,Completely unacceptable,,,Completely acceptable,,,Somewhat acceptable,,,Very important,Very important,Extremely important,Very important,Slightly important,Extremely important,Moderately important,Moderately important,Very important,,6.0,2.0,7.0,1.0,3.0,5.0,4.0,,,,,,
268,True,1952.0,Facebook,59.0,Male,White / Caucasian,Some college,Slightly conservative,Slightly aware,"['… are large and can contain millions of data points', '… reflect events in real-time and can be collected continuously over time', '… are naturalistic in that they do not require researchers to directly interact with research volunteers', '… often capture social relationships not found using traditional methods (e.g. surveys)', '… are readily accessible to researchers and easy to collect']","['Privately messaging users', ""Publicly posting on users' profiles""]","['Political elections (e.g. voting behavior)', 'Health topics (e.g. spread of diseases)', 'Well-being and economic satisfaction', 'Communication (e.g. spread of opinions and hate-speech)', 'Public sentiment (e.g. environment-related concerns)', 'News consumption (e.g. sharing of misinformation)', 'Social networks']",3,2,7,That certain ethical approach was used to procure and analyze data.,Completely acceptable,curious; empathizing with the content of the tweet or empathizing with the sad condition one is in to propagate hate?,,Completely acceptable,what was the actual content of the private message? how long were the study subjects followed and what percentage reverted to random misinformation as time went on?,"i find that some people can be swayed briefly, but revert to old behaviors as more toxic posts are circulated between two accounts (1 facebook and 1 instagram) i have nearly 20,000 followers; i see this trend [of reverting to negative behaviors] frequently",Somewhat acceptable,"i assume that the behavior changed through the course of the study, but what happened after the study was over? did the study participants revert?",,Completely acceptable,"i am not surprised that the misinformed would defend their position publicly it is almost common sense to assume that one who is posting ‘toxicity’ will dig in for the fight, if one follows any social media engagement",,Very important,Very important,Very important,Extremely important,Not at all important,Very important,Moderately important,Moderately important,Extremely important,,4.0,6.0,7.0,2.0,1.0,3.0,5.0,"revisiting over periods of time (initial contact, 24hrs, 2 days, 2 weeks, 1 month, etc) as time allows",8.0,,,,
269,True,781.0,Reddit,39.0,Female,White / Caucasian,Highschool,Slightly conservative,Very aware,"['… are large and can contain millions of data points', '… are naturalistic in that they do not require researchers to directly interact with research volunteers', '… are readily accessible to researchers and easy to collect']","['Privately messaging users', ""Publicly posting on users' profiles"", 'Creating fake accounts (""bots"")']","['Political elections (e.g. voting behavior)', 'Economic forecasting', 'Presidential approval ratings', 'Health topics (e.g. spread of diseases)', 'Communication (e.g. spread of opinions and hate-speech)', 'Public sentiment (e.g. environment-related concerns)', 'News consumption (e.g. sharing of misinformation)', 'Social networks']",1,3,8,that means that they have to have wriiten approval that the research is on agreed terms,Somewhat acceptable,,,Somewhat acceptable,there is nothing wrong with it and the targeted people had a choice to rate or not they weren't forced,,Neutral,,,Somewhat acceptable,"personally i don't see too much wrong with this, though i think they should have reached out for permission after getting the reply and before sharing it",,Very important,Slightly important,Extremely important,Very important,Moderately important,Very important,Moderately important,Very important,Extremely important,not that i can think of off the top of my head,6.0,2.0,7.0,5.0,1.0,4.0,3.0,more communication with the participants,1.0,,,,
270,True,427.0,Facebook,55.0,Male,Hispanic,Bachelor's degree,Slightly conservative,Very aware,"['… are naturalistic in that they do not require researchers to directly interact with research volunteers', '… often capture social relationships not found using traditional methods (e.g. surveys)']","['Creating fake accounts (""bots"")', 'Secretly changing the content of what users see']","['Political elections (e.g. voting behavior)', 'Economic forecasting', 'Presidential approval ratings', 'Health topics (e.g. spread of diseases)', 'Communication (e.g. spread of opinions and hate-speech)', 'News consumption (e.g. sharing of misinformation)']",2,0,6,approval of the means used to carry out the research,Completely unacceptable,,,Completely unacceptable,,,Neutral,,,Completely unacceptable,,,Very important,Very important,Extremely important,Moderately important,Moderately important,Very important,Very important,Very important,Very important,,5.0,1.0,3.0,4.0,7.0,6.0,2.0,,1.0,,2.0,,3.0
271,True,495.0,Reddit,34.0,Male,White / Caucasian,Bachelor's degree,Slightly liberal,Slightly aware,"['… are large and can contain millions of data points', '… reflect events in real-time and can be collected continuously over time', '… are naturalistic in that they do not require researchers to directly interact with research volunteers', '… often capture social relationships not found using traditional methods (e.g. surveys)', '… are readily accessible to researchers and easy to collect']","['Privately messaging users', ""Publicly posting on users' profiles"", 'Creating fake accounts (""bots"")']","['Political elections (e.g. voting behavior)', 'Economic forecasting', 'Presidential approval ratings', 'Health topics (e.g. spread of diseases)', 'Well-being and economic satisfaction', 'Communication (e.g. spread of opinions and hate-speech)', 'Public sentiment (e.g. environment-related concerns)', 'News consumption (e.g. sharing of misinformation)', 'Social networks']",3,3,9,Is the research aimed at entertaining a hypothesis that is motivated aside from the advancement of science.,Completely acceptable,,,Somewhat unacceptable,only took conservative people in sample any result will be a hit on conservatives,,Somewhat acceptable,"the reward was different for different people although they chose, a lottery is different than receiving money outright",,Completely acceptable,did they sample from both political parties equally?,,Slightly important,Slightly important,Extremely important,Moderately important,Moderately important,Slightly important,Moderately important,Extremely important,Slightly important,"broader principle of who they are sampling and what they are testing in this climate, sampling a bunch of conservatives or liberals and looking for some negative trait seems disengenuous",5.0,6.0,2.0,4.0,7.0,1.0,3.0,"reason for doing study is this tabloid psychology science, research for someone to get their masters, or something we really want to understand and care about deeply",1.0,,,,
272,True,360.0,Facebook,40.0,Female,White / Caucasian,Master's degree or above,Very liberal,Very aware,"['… are naturalistic in that they do not require researchers to directly interact with research volunteers', '… often capture social relationships not found using traditional methods (e.g. surveys)']","['Privately messaging users', ""Publicly posting on users' profiles"", 'Creating fake accounts (""bots"")', 'Secretly changing the content of what users see']","['Political elections (e.g. voting behavior)', 'Economic forecasting', 'Presidential approval ratings', 'Health topics (e.g. spread of diseases)', 'Well-being and economic satisfaction', 'Communication (e.g. spread of opinions and hate-speech)', 'Public sentiment (e.g. environment-related concerns)', 'News consumption (e.g. sharing of misinformation)', 'Social networks']",2,2,9,A general level of it is acceptable to perform this activity because the majority of people would believe it is ok.,Somewhat acceptable,,,Neutral,,,Completely acceptable,users given opportunity to voluntarily participate in exchange for some type of reward  i see this as completely ethical,,Somewhat acceptable,,,Very important,Slightly important,Very important,Not at all important,Not at all important,Very important,Moderately important,Not at all important,Not at all important,,2.0,4.0,3.0,1.0,5.0,7.0,6.0,,,,,,
273,True,642.0,Reddit,52.0,Male,White / Caucasian,Bachelor's degree,Slightly conservative,Moderately aware,"['… are large and can contain millions of data points', '… reflect events in real-time and can be collected continuously over time', '… are naturalistic in that they do not require researchers to directly interact with research volunteers', '… often capture social relationships not found using traditional methods (e.g. surveys)', '… are readily accessible to researchers and easy to collect']","['Privately messaging users', ""Publicly posting on users' profiles"", 'Creating fake accounts (""bots"")']","['Political elections (e.g. voting behavior)', 'Presidential approval ratings', 'Well-being and economic satisfaction', 'Communication (e.g. spread of opinions and hate-speech)', 'Public sentiment (e.g. environment-related concerns)', 'News consumption (e.g. sharing of misinformation)', 'Social networks']",3,3,7,"For me, ethical approval means that the topic of research and manner of gathering the data do not go against the spirit and rules of the institution that they work for, and will not cause it reputational damage.",Somewhat unacceptable,"i find this unacceptable as the participants in the survey were unaware that they were involved, as well as the topic (hate speech) being one that is dangerous ground to venture into from a reputational perspective",,Somewhat unacceptable,"again, the fact that the participants were unaware that they were part of a survey seems unacceptable to me",,Completely acceptable,"this seems absolutely fine to me, as the researchers were open and transparent throughout as to what they were doing",,Somewhat unacceptable,"same response, unacceptable since the individuals did not know they were part of a survey",,Not at all important,Not at all important,Moderately important,Not at all important,Not at all important,Slightly important,Extremely important,Not at all important,Slightly important,,6.0,2.0,7.0,4.0,3.0,5.0,1.0,,,,,,
274,True,583.0,Reddit,34.0,Male,White / Caucasian,Bachelor's degree,Very liberal,Very aware,"['… are large and can contain millions of data points', '… are naturalistic in that they do not require researchers to directly interact with research volunteers', '… often capture social relationships not found using traditional methods (e.g. surveys)', '… are readily accessible to researchers and easy to collect']","['Privately messaging users', ""Publicly posting on users' profiles"", 'Creating fake accounts (""bots"")']","['Political elections (e.g. voting behavior)', 'Health topics (e.g. spread of diseases)', 'Well-being and economic satisfaction', 'Communication (e.g. spread of opinions and hate-speech)', 'Public sentiment (e.g. environment-related concerns)', 'News consumption (e.g. sharing of misinformation)', 'Social networks']",2,3,7,I think ethical approval would encompass the use of the data collected. This would mean that the researchers are handling the data in a secure and responsible way so as to respect the anonymity of the users.,Somewhat acceptable,my first thought and concern would be that twitter is not a safe speech space it is a a corporate owned space and the ability to go through with this research should probably be consented by twitter itself,,Somewhat acceptable,"i consider an ends justifies the means approach to thinking on this one as mentioned before, this space is not publicly owned and to conduct this research do not violate norms",,Completely acceptable,"i see consent as being the largest factor for ethical use once the participants have voluntarily given their consent and knowledge of the research, it is all fair game",,Neutral,,,Moderately important,Very important,Extremely important,Moderately important,Moderately important,Moderately important,Slightly important,Very important,Very important,,1.0,7.0,4.0,6.0,2.0,3.0,5.0,,,,,,
275,True,1591.0,Facebook,51.0,Female,White / Caucasian,Bachelor's degree,Prefer not to say,Extremely aware,"['… are large and can contain millions of data points', '… reflect events in real-time and can be collected continuously over time', '… are naturalistic in that they do not require researchers to directly interact with research volunteers', '… are readily accessible to researchers and easy to collect']","[""Publicly posting on users' profiles"", 'Creating fake accounts (""bots"")', 'Secretly changing the content of what users see']","['Political elections (e.g. voting behavior)', 'Economic forecasting', 'Presidential approval ratings', 'Health topics (e.g. spread of diseases)', 'Well-being and economic satisfaction', 'Communication (e.g. spread of opinions and hate-speech)', 'Public sentiment (e.g. environment-related concerns)', 'News consumption (e.g. sharing of misinformation)']",2,1,8,Ethical approval means that the research study was reviewed and the study adheres to all ethical standards and all potential risks were deemed acceptable.,Completely unacceptable,,,Somewhat unacceptable,,,Completely acceptable,,,Completely unacceptable,,,Extremely important,Slightly important,Extremely important,Very important,Extremely important,Extremely important,Extremely important,Extremely important,Extremely important,who is performing the research study,7.0,3.0,6.0,2.0,1.0,5.0,4.0,contact information for the researchers,8.0,information about who the researchers are,6.0,None,4.0
276,True,966.0,Twitter,43.0,Female,White / Caucasian,Associate's degree,Neutral/ Neither conservative or liberal,Extremely aware,"['… are large and can contain millions of data points', '… reflect events in real-time and can be collected continuously over time', '… are naturalistic in that they do not require researchers to directly interact with research volunteers', '… often capture social relationships not found using traditional methods (e.g. surveys)', '… are readily accessible to researchers and easy to collect']","['Privately messaging users', ""Publicly posting on users' profiles"", 'Creating fake accounts (""bots"")', 'Secretly changing the content of what users see']","['Political elections (e.g. voting behavior)', 'Economic forecasting', 'Presidential approval ratings', 'Health topics (e.g. spread of diseases)', 'Well-being and economic satisfaction', 'Communication (e.g. spread of opinions and hate-speech)', 'Public sentiment (e.g. environment-related concerns)', 'News consumption (e.g. sharing of misinformation)', 'Social networks']",3,2,9,"A part of the research process, whose purpose is to protect both the researcher and the participants in the research.",Completely acceptable,it is completely acceptable because in my opinion public social media posts are fair game the researchers are also not encouraging harmful or hateful behavior,,Completely acceptable,"the study is acceptable and totally ethical in my opinion like i said public social media posts are fair game the researchers also did not encourage abusive, misleading, or harmful behavior",,Completely acceptable,"it it totally acceptable because the participants in the research had free will, were informed of what they were doing, and weren't forced into anything they were also offered compensation for the data provided",,Somewhat acceptable,"as i said in the other replies, public social media posts are fair game the researchers did not encourage hateful behavior the researchers only encouraged fact checking if some of the people who were analyzed chose to behave in a hateful or toxic manner in response to the bots, that was their own choice these types typical act hateful or toxic to anyone, not just bots and researchers",,Not at all important,Not at all important,Very important,Slightly important,Not at all important,Very important,Not at all important,Very important,Not at all important,"i think if researchers mislead social media users in private, that is a problem if the researchers encourage hateful or provocative behavior, that is a problem however, none of the studies presented earlier encouraged bad behavior, nor did they target the social media user account in private, so i see no problem with it as i said just about every time, public social media is fair game if you don't want to be analyzed don't post on social media",4.0,7.0,6.0,2.0,1.0,5.0,3.0,,,,,,
277,True,1418.0,Twitter,52.0,Male,Hispanic,Bachelor's degree,Slightly liberal,Not at all aware,"['… are large and can contain millions of data points', '… reflect events in real-time and can be collected continuously over time', '… often capture social relationships not found using traditional methods (e.g. surveys)', '… are readily accessible to researchers and easy to collect']","['Privately messaging users', ""Publicly posting on users' profiles"", 'Creating fake accounts (""bots"")', 'Secretly changing the content of what users see']","['Political elections (e.g. voting behavior)', 'Economic forecasting', 'Presidential approval ratings', 'Health topics (e.g. spread of diseases)', 'Well-being and economic satisfaction', 'Communication (e.g. spread of opinions and hate-speech)', 'Public sentiment (e.g. environment-related concerns)', 'News consumption (e.g. sharing of misinformation)', 'Social networks']",2,2,9,It doesn't name people. It won't cause them undue harm.,Somewhat acceptable,,,Somewhat acceptable,,,Somewhat acceptable,,,Somewhat acceptable,,,Slightly important,Very important,Very important,Very important,Slightly important,Slightly important,Very important,Very important,Moderately important,it seems fine to me i just don't interact enough to know what kind of effect it would have on me personally,7.0,3.0,5.0,2.0,1.0,6.0,4.0,,8.0,,9.0,,10.0
278,True,448.0,Facebook,44.0,Female,White / Caucasian,Bachelor's degree,Slightly liberal,Slightly aware,"['… are large and can contain millions of data points', '… reflect events in real-time and can be collected continuously over time', '… are naturalistic in that they do not require researchers to directly interact with research volunteers', '… often capture social relationships not found using traditional methods (e.g. surveys)', '… are readily accessible to researchers and easy to collect']","[""Publicly posting on users' profiles"", 'Creating fake accounts (""bots"")', 'Secretly changing the content of what users see']","['Economic forecasting', 'Health topics (e.g. spread of diseases)', 'Well-being and economic satisfaction', 'News consumption (e.g. sharing of misinformation)', 'Social networks']",3,1,5,That the methods used don’t violate any code of ethics.,Somewhat acceptable,,,Somewhat unacceptable,,,Completely acceptable,,,Somewhat acceptable,,,Moderately important,Not at all important,Very important,Slightly important,Slightly important,Moderately important,Very important,Slightly important,Slightly important,,4.0,3.0,6.0,5.0,1.0,7.0,2.0,,,,,,
279,True,609.0,Twitter,27.0,Male,White / Caucasian,Highschool,Neutral/ Neither conservative or liberal,Very aware,"['… reflect events in real-time and can be collected continuously over time', '… often capture social relationships not found using traditional methods (e.g. surveys)', '… are always representative of people’s offline behavior', '… are well formatted and never contain any missing data']",['Privately messaging users'],"['Well-being and economic satisfaction', 'Public sentiment (e.g. environment-related concerns)', 'Social networks']",0,1,3,It means it's work that is done in the way it's intended.,Completely unacceptable,None,,Somewhat acceptable,,,Somewhat acceptable,,,Somewhat unacceptable,,,Very important,Very important,Very important,Very important,Very important,Very important,Very important,Very important,Very important,,7.0,5.0,4.0,2.0,6.0,3.0,1.0,,,,,,
280,True,419.0,Reddit,20.0,Male,White / Caucasian,Highschool,Very liberal,Very aware,"['… are large and can contain millions of data points', '… reflect events in real-time and can be collected continuously over time', '… often capture social relationships not found using traditional methods (e.g. surveys)', '… are readily accessible to researchers and easy to collect']","[""Publicly posting on users' profiles""]","['Political elections (e.g. voting behavior)', 'Communication (e.g. spread of opinions and hate-speech)', 'Public sentiment (e.g. environment-related concerns)', 'News consumption (e.g. sharing of misinformation)', 'Social networks']",2,1,5,Ethical approval means that someone from higher up within the research institution has reviewed the research methodology. They have determined it follows common ethical guidelines and is free of large-scale social biases.,Neutral,,,Somewhat acceptable,i do not see anything particularly problematic about this study - if the private message sent was something human-like,the contents of the private message,Somewhat unacceptable,i think it was a fairly blatant invasion of privacy to have the users downloading that browser extension that tracked the news sites that were visited,the information the users were given about what data would be collected once the app was downlnoade,Somewhat acceptable,the automated fact checker replies seem like something that i would expect the social media site themselves to do when it comes to 'false' tweets,,Very important,Not at all important,Moderately important,Slightly important,Slightly important,Extremely important,Extremely important,Very important,Moderately important,the purpose of the messagesinformationreplies sent to the user,6.0,1.0,5.0,2.0,3.0,7.0,4.0,,8.0,,,,
281,True,461.0,Reddit,23.0,Male,White / Caucasian,Highschool,Slightly liberal,Very aware,"['… are large and can contain millions of data points', '… reflect events in real-time and can be collected continuously over time', '… are naturalistic in that they do not require researchers to directly interact with research volunteers', '… often capture social relationships not found using traditional methods (e.g. surveys)', '… are readily accessible to researchers and easy to collect']","['Privately messaging users', 'Creating fake accounts (""bots"")', 'Secretly changing the content of what users see', ""Hacking into users' accounts""]","['Political elections (e.g. voting behavior)', 'Presidential approval ratings', 'Health topics (e.g. spread of diseases)', 'Well-being and economic satisfaction', 'Communication (e.g. spread of opinions and hate-speech)', 'Public sentiment (e.g. environment-related concerns)', 'News consumption (e.g. sharing of misinformation)', 'Social networks']",3,0,8,A review that shows their research and experiment is in line with the code of ethics. A more extreme example would be testing a new drug on animals before human trials.,Completely acceptable,,,Completely acceptable,,,Completely acceptable,,,Somewhat acceptable,it is against twitters tos to use unapproved bots on their platform,if they got approval from twitter to use those bots or not,Very important,Very important,Very important,Moderately important,Extremely important,Moderately important,Not at all important,Extremely important,Moderately important,,4.0,7.0,5.0,2.0,1.0,6.0,3.0,,,,,,
282,True,742.0,Reddit,39.0,Male,Asian - Indian,Master's degree or above,Slightly liberal,Very aware,"['… are large and can contain millions of data points', '… reflect events in real-time and can be collected continuously over time', '… often capture social relationships not found using traditional methods (e.g. surveys)', '… are readily accessible to researchers and easy to collect']","[""Publicly posting on users' profiles"", 'Creating fake accounts (""bots"")', 'Secretly changing the content of what users see']","['Political elections (e.g. voting behavior)', 'Economic forecasting', 'Presidential approval ratings', 'Health topics (e.g. spread of diseases)', 'Well-being and economic satisfaction', 'Communication (e.g. spread of opinions and hate-speech)', 'Public sentiment (e.g. environment-related concerns)', 'News consumption (e.g. sharing of misinformation)', 'Social networks']",2,1,9,Ethical approval means that the data will be used for pure research purpose and will not be shared outside of the research with anyone and will not be used for any other purposes (whether legal or illegal).,Somewhat unacceptable,user consent was not obtained to conduct the study,"while collecting the user data if the researchers did not collect any pii, i would mark this acceptable",Neutral,"user consent was not obtained, but at least privacy was used when targeting users",,Somewhat unacceptable,i have concern with the extension installation,the users should have been informed the potential uses of the extension the extension might be collecting users personal browsing data as well and the user should have known that,Somewhat acceptable,this is an interesting study and what was done in ethical,"i would like to see the distribution of the 2000 users they selected across geographies, gender and race to make sure its not biased",Moderately important,Moderately important,Extremely important,Moderately important,Moderately important,Very important,Extremely important,Moderately important,Extremely important,collection of pii without user consent,3.0,2.0,4.0,1.0,7.0,5.0,6.0,data analysis tools being used (like extensions),6.0,,8.0,adherence to regulations (like gdpr),6.0
283,True,1275.0,Reddit,20.0,Male,White / Caucasian,Some college,Slightly liberal,Extremely aware,"['… are large and can contain millions of data points', '… reflect events in real-time and can be collected continuously over time', '… are naturalistic in that they do not require researchers to directly interact with research volunteers', '… often capture social relationships not found using traditional methods (e.g. surveys)', '… are readily accessible to researchers and easy to collect']","['Privately messaging users', ""Publicly posting on users' profiles"", 'Creating fake accounts (""bots"")']","['Political elections (e.g. voting behavior)', 'Economic forecasting', 'Presidential approval ratings', 'Health topics (e.g. spread of diseases)', 'Well-being and economic satisfaction', 'Communication (e.g. spread of opinions and hate-speech)', 'Public sentiment (e.g. environment-related concerns)', 'News consumption (e.g. sharing of misinformation)', 'Social networks']",3,3,9,"Taking it to an ethics  board that reviews what the researchers want to do, why they want to do it, and how they want to do it.",Somewhat acceptable,"same as the first study about how i wouldn't want to unknowingly or unwilling be in a research study, but anything that you post for everyone to see on the internet is availed for everyone to see including researchers and people need to be aware of that","again just if the people studied were given the option to have their data anonymized or deleted, and whether or not this went to an ethics review board prior to the study",Somewhat acceptable,exact same concerns as the previous study,exact same as the previous study,Completely acceptable,"i think this study was perfect the people in it knew about their participation, participated willingly, and were compensated","even though i find this perfectly ethical, i still think any research that will be used in a study of some sorts needs to be reviewed by an ethics board",Somewhat acceptable,"i don't like the idea of being in a research study unknowingly or unwillingly, but i very much see the value in it, and i also think that anything posted on sites such as twitter, facebook, instagram, reddit, etc are available for everyone and are free game","whether or not the person was later informed they were in a research study, whether or not they were given the option for the data collected about them to either be anonymized or taken out entirely, and whether or not this study went to a review board prior to the start",Not at all important,Slightly important,Not at all important,Slightly important,Slightly important,Not at all important,Moderately important,Slightly important,Not at all important,"whether or not the people studied are aware after the fact, and whether or not they have the option for their data to be anonymized or deleted whether or not the study went to a review board prior to the start of the study",5.0,7.0,3.0,2.0,1.0,6.0,4.0,,,,,,
284,True,524.0,Facebook,48.0,Female,White / Caucasian,Bachelor's degree,Slightly conservative,Slightly aware,"['… are large and can contain millions of data points', '… reflect events in real-time and can be collected continuously over time', '… are naturalistic in that they do not require researchers to directly interact with research volunteers', '… often capture social relationships not found using traditional methods (e.g. surveys)', '… are readily accessible to researchers and easy to collect']","['Privately messaging users', 'Creating fake accounts (""bots"")']","['Political elections (e.g. voting behavior)', 'Presidential approval ratings', 'Health topics (e.g. spread of diseases)', 'Well-being and economic satisfaction', 'Communication (e.g. spread of opinions and hate-speech)', 'Public sentiment (e.g. environment-related concerns)', 'News consumption (e.g. sharing of misinformation)', 'Social networks']",3,2,8,I think it means that the study will be conducted without the intent to cause harm to others.,Completely acceptable,i think that being empathetic is the right thing to do and nothing about this study was hurtful,i find empathy to be morally acceptable so i don't have a problem with it,Somewhat acceptable,i don't really agree with the private messaging thing  i don't like feeling like my personal space is being crossed,the private messaging bothers me a little  i think if you post a public post others have the right to comment but that doesn't mean i want to be contacted privately,Completely acceptable,,,Completely acceptable,,,Moderately important,Moderately important,Moderately important,Slightly important,Moderately important,Extremely important,Very important,Very important,Moderately important,,7.0,6.0,2.0,1.0,5.0,4.0,3.0,,,,,,
285,True,721.0,Facebook,20.0,Male,White / Caucasian,Bachelor's degree,Neutral/ Neither conservative or liberal,Moderately aware,"['… are large and can contain millions of data points', '… reflect events in real-time and can be collected continuously over time', '… are naturalistic in that they do not require researchers to directly interact with research volunteers', '… are readily accessible to researchers and easy to collect', '… are well formatted and never contain any missing data']","['Privately messaging users', 'Creating fake accounts (""bots"")']","['Presidential approval ratings', 'Health topics (e.g. spread of diseases)', 'Communication (e.g. spread of opinions and hate-speech)', 'News consumption (e.g. sharing of misinformation)', 'Social networks']",1,2,5,To make sure the study is going to moral. Like not go against basic human rights and not harm anybody in anyway. ,Completely acceptable,,,Completely acceptable,"again, very acceptable in my opinion because a normal person could have privately messaged them",,Completely acceptable,,,Completely acceptable,it is fine because a normal person could have done the same thing,depends on how the researches were replying after that,Extremely important,Extremely important,Extremely important,Extremely important,Very important,Very important,Extremely important,Very important,Extremely important,,6.0,4.0,3.0,2.0,1.0,7.0,5.0,None,4.0,,5.0,,
286,True,980.0,Facebook,67.0,Male,White / Caucasian,Highschool,Very conservative,Moderately aware,"['… are large and can contain millions of data points', '… reflect events in real-time and can be collected continuously over time', '… often capture social relationships not found using traditional methods (e.g. surveys)', '… are readily accessible to researchers and easy to collect']","['Privately messaging users', ""Publicly posting on users' profiles"", 'Creating fake accounts (""bots"")']","['Political elections (e.g. voting behavior)', 'Economic forecasting', 'Presidential approval ratings', 'Health topics (e.g. spread of diseases)', 'Well-being and economic satisfaction', 'Communication (e.g. spread of opinions and hate-speech)', 'Public sentiment (e.g. environment-related concerns)', 'News consumption (e.g. sharing of misinformation)', 'Social networks']",2,3,9,Adherence to accepted ethical standards.,Completely acceptable,,,Completely acceptable,,,Completely acceptable,,,Completely acceptable,,,Extremely important,Slightly important,Extremely important,Moderately important,Slightly important,Extremely important,Extremely important,Very important,Extremely important,,6.0,2.0,5.0,1.0,7.0,4.0,3.0,,,,,,
287,True,517.0,Facebook,37.0,Male,Asian - Indian,Master's degree or above,Neutral/ Neither conservative or liberal,Extremely aware,"['… are large and can contain millions of data points', '… reflect events in real-time and can be collected continuously over time', '… often capture social relationships not found using traditional methods (e.g. surveys)', '… are readily accessible to researchers and easy to collect', '… are well formatted and never contain any missing data']","['Privately messaging users', ""Publicly posting on users' profiles"", 'Creating fake accounts (""bots"")']","['Political elections (e.g. voting behavior)', 'Economic forecasting', 'Presidential approval ratings', 'Health topics (e.g. spread of diseases)', 'Well-being and economic satisfaction', 'Communication (e.g. spread of opinions and hate-speech)', 'News consumption (e.g. sharing of misinformation)', 'Social networks']",1,3,8,It tells the study is used for useful purposes without abusing the participant in any way. ,Somewhat acceptable,,,Neutral,,,Completely acceptable,,,Somewhat acceptable,,,Moderately important,Slightly important,Slightly important,Slightly important,Very important,Moderately important,Moderately important,Slightly important,Moderately important,,1.0,6.0,5.0,2.0,4.0,3.0,7.0,,,,,,
288,True,1188.0,Reddit,34.0,Male,White / Caucasian,Master's degree or above,Neutral/ Neither conservative or liberal,Moderately aware,"['… are large and can contain millions of data points', '… reflect events in real-time and can be collected continuously over time', '… are naturalistic in that they do not require researchers to directly interact with research volunteers', '… often capture social relationships not found using traditional methods (e.g. surveys)', '… are readily accessible to researchers and easy to collect']","[""Publicly posting on users' profiles"", 'Secretly changing the content of what users see']","['Political elections (e.g. voting behavior)', 'Economic forecasting', 'Presidential approval ratings', 'Health topics (e.g. spread of diseases)', 'Well-being and economic satisfaction', 'Communication (e.g. spread of opinions and hate-speech)', 'Public sentiment (e.g. environment-related concerns)', 'News consumption (e.g. sharing of misinformation)', 'Social networks']",3,0,9,Being honest and not knowingly affecting people in negative ways.  Not identifying individuals without their consent.,Neutral,,,Neutral,,,Completely acceptable,,,Neutral,,,Very important,Slightly important,Slightly important,Slightly important,Slightly important,Slightly important,Very important,Extremely important,Slightly important,,4.0,5.0,2.0,6.0,1.0,7.0,3.0,,,,,,
289,True,836.0,Facebook,67.0,Male,White / Caucasian,Vocational training,Very liberal,Moderately aware,"['… are naturalistic in that they do not require researchers to directly interact with research volunteers', '… are readily accessible to researchers and easy to collect']","['Creating fake accounts (""bots"")']","['Political elections (e.g. voting behavior)', 'Economic forecasting', 'Presidential approval ratings', 'Health topics (e.g. spread of diseases)', 'Well-being and economic satisfaction', 'Communication (e.g. spread of opinions and hate-speech)', 'Public sentiment (e.g. environment-related concerns)', 'News consumption (e.g. sharing of misinformation)', 'Social networks']",0,1,9,Implies that the institution represented approves of the ethics of the researcher's data collection methods.,Somewhat acceptable,,,Neutral,,,Completely acceptable,,,Somewhat acceptable,,,Very important,Extremely important,Slightly important,Moderately important,Very important,Slightly important,Extremely important,Very important,Moderately important,,3.0,4.0,1.0,7.0,2.0,5.0,6.0,,,,,,
290,True,1976.0,Twitter,24.0,Female,African-American,Highschool,Very liberal,Extremely aware,"['… are large and can contain millions of data points', '… are readily accessible to researchers and easy to collect', '… are always representative of people’s offline behavior']","['Creating fake accounts (""bots"")']","['Political elections (e.g. voting behavior)', 'Presidential approval ratings', 'Well-being and economic satisfaction', 'Communication (e.g. spread of opinions and hate-speech)', 'Social networks']",-1,1,5,I think it means approval where the institution knows and aware of what they approving.,Somewhat acceptable,,,Somewhat unacceptable,,,Completely acceptable,,,Somewhat unacceptable,,i would find it ethical if they people actually knew about it,Extremely important,Moderately important,Very important,Very important,Very important,Moderately important,Very important,Extremely important,Very important,,3.0,7.0,4.0,2.0,1.0,6.0,5.0,,,,,,
291,True,1411.0,Facebook,43.0,Male,White / Caucasian,Highschool,Slightly conservative,Extremely aware,"['… are large and can contain millions of data points', '… are readily accessible to researchers and easy to collect']","['Creating fake accounts (""bots"")']","['Political elections (e.g. voting behavior)', 'Presidential approval ratings', 'Communication (e.g. spread of opinions and hate-speech)', 'Public sentiment (e.g. environment-related concerns)', 'News consumption (e.g. sharing of misinformation)', 'Social networks']",0,1,6,It means that it follows the given set of rules and principals expected of them.,Completely unacceptable,users should always be made aware,,Completely unacceptable,they should been made aware of the experiment beforehand,,Completely acceptable,,,Completely unacceptable,"once again, they should have made users aware and could have potentially spread false information themselves",,Extremely important,Extremely important,Not at all important,Moderately important,Very important,Slightly important,Extremely important,Extremely important,Moderately important,None,6.0,2.0,4.0,3.0,1.0,7.0,5.0,,3.0,,9.0,ethical application in the real world,10.0
292,True,497.0,Facebook,66.0,Female,White / Caucasian,Master's degree or above,Very conservative,Moderately aware,"['… are large and can contain millions of data points', '… are naturalistic in that they do not require researchers to directly interact with research volunteers', '… are readily accessible to researchers and easy to collect']",['None of the above'],"['Political elections (e.g. voting behavior)', 'Presidential approval ratings', 'Well-being and economic satisfaction', 'Public sentiment (e.g. environment-related concerns)']",1,0,4,Ethical approval is a review of the methods to be used to insure that no one is potentially harmed in the collection of data.,Completely unacceptable,,,Completely unacceptable,,,Neutral,,,Completely unacceptable,,,Extremely important,Very important,Moderately important,Very important,Very important,Extremely important,Extremely important,Slightly important,Very important,,3.0,1.0,7.0,6.0,2.0,4.0,5.0,,,,,,
293,True,1481.0,Twitter,27.0,Male,African-American,Bachelor's degree,Slightly liberal,Slightly aware,"['… are large and can contain millions of data points', '… reflect events in real-time and can be collected continuously over time', '… are naturalistic in that they do not require researchers to directly interact with research volunteers', '… are readily accessible to researchers and easy to collect', '… are unaffected by the way social media platforms work']",['Privately messaging users'],"['Political elections (e.g. voting behavior)', 'Economic forecasting', 'Health topics (e.g. spread of diseases)', 'Communication (e.g. spread of opinions and hate-speech)', 'Social networks']",1,1,5,it means they would stick to the rules of a proper research study,Completely acceptable,,,Completely acceptable,,,Completely acceptable,,,Completely acceptable,,,Slightly important,Extremely important,Very important,Slightly important,Moderately important,Not at all important,Slightly important,Moderately important,Slightly important,,4.0,2.0,5.0,6.0,1.0,3.0,7.0,,,,,,
294,True,1627.0,Facebook,62.0,Female,White / Caucasian,Master's degree or above,Neutral/ Neither conservative or liberal,Very aware,"['… reflect events in real-time and can be collected continuously over time', '… often capture social relationships not found using traditional methods (e.g. surveys)', '… are readily accessible to researchers and easy to collect']","['Creating fake accounts (""bots"")']","['Political elections (e.g. voting behavior)', 'Economic forecasting', 'Presidential approval ratings', 'Health topics (e.g. spread of diseases)', 'Communication (e.g. spread of opinions and hate-speech)']",1,1,5,goes along with the laws of that country /state,Completely unacceptable,,small sector and short time frame   need consent,Completely unacceptable,the users should have informed consent,check the laws of the state especially privacy,Completely unacceptable,,data should have been shown in a comparison form,Completely unacceptable,uninformed consent and missinturpted info,study was based on a small sector,Extremely important,Extremely important,Extremely important,Extremely important,Extremely important,Extremely important,Extremely important,Extremely important,Extremely important,,5.0,1.0,6.0,3.0,4.0,7.0,2.0,consent has to do with relevant facts,1.0,laws keep lawsuits to a minimal,2.0,,4.0
295,True,370.0,Reddit,27.0,Male,White / Caucasian,Master's degree or above,Very liberal,Not at all aware,"['… are large and can contain millions of data points', '… reflect events in real-time and can be collected continuously over time', '… are naturalistic in that they do not require researchers to directly interact with research volunteers', '… often capture social relationships not found using traditional methods (e.g. surveys)', '… are readily accessible to researchers and easy to collect']","['Privately messaging users', 'Creating fake accounts (""bots"")']","['Political elections (e.g. voting behavior)', 'Economic forecasting', 'Presidential approval ratings', 'Health topics (e.g. spread of diseases)', 'Well-being and economic satisfaction', 'Communication (e.g. spread of opinions and hate-speech)', 'Public sentiment (e.g. environment-related concerns)', 'News consumption (e.g. sharing of misinformation)', 'Social networks']",3,2,9,That they talk to an IRB who decides if the proposal for the study meets their ethical requirements.,Somewhat acceptable,"i think it's probably fine if it's public, no pm's involved, because the pm's are of a more intimate nature",,Somewhat unacceptable,it's weird that they weren't informed they were in a study,knowing if their data was kept secure,Somewhat acceptable,"they were informed that they were participating in a study, i see no issue here the only issue is that they would have to forego a reward to see the study results",,Somewhat acceptable,"i have the same thoughts as the previous study it's public, and therefore more likely to be acceptable",,Extremely important,Slightly important,Very important,Not at all important,Slightly important,Extremely important,Extremely important,Not at all important,Extremely important,"making sure that people are compensated and able to view study results that's an issue i didn't think of earlier with compensation in the studies where participants were not aware i realize in hindsight if they're going to be part of research, they should be compensated",7.0,1.0,6.0,3.0,2.0,5.0,4.0,,6.0,,,,
296,True,417.0,Facebook,30.0,Female,White / Caucasian,Bachelor's degree,Very liberal,Very aware,"['… are naturalistic in that they do not require researchers to directly interact with research volunteers', '… often capture social relationships not found using traditional methods (e.g. surveys)', '… are readily accessible to researchers and easy to collect', '… are unaffected by the way social media platforms work']","['Privately messaging users', 'Creating fake accounts (""bots"")']","['Political elections (e.g. voting behavior)', 'Economic forecasting', 'Presidential approval ratings', 'Health topics (e.g. spread of diseases)', 'Well-being and economic satisfaction', 'Communication (e.g. spread of opinions and hate-speech)', 'Public sentiment (e.g. environment-related concerns)', 'News consumption (e.g. sharing of misinformation)', 'Social networks']",0,2,9,I would think that it means that their peers believe that what they are doing is not harmful,Completely acceptable,,,Completely acceptable,,,Completely acceptable,,,Completely acceptable,,,Extremely important,Extremely important,Extremely important,Moderately important,Not at all important,Not at all important,Slightly important,Not at all important,Extremely important,,5.0,6.0,4.0,3.0,2.0,7.0,1.0,,,,,,
297,True,2734.0,Facebook,52.0,Female,White / Caucasian,Associate's degree,Neutral/ Neither conservative or liberal,Not at all aware,"['… reflect events in real-time and can be collected continuously over time', '… often capture social relationships not found using traditional methods (e.g. surveys)', '… are readily accessible to researchers and easy to collect', '… are always representative of people’s offline behavior']","['Privately messaging users', ""Publicly posting on users' profiles""]","['Political elections (e.g. voting behavior)', 'Economic forecasting', 'Presidential approval ratings', 'Communication (e.g. spread of opinions and hate-speech)', 'Public sentiment (e.g. environment-related concerns)', 'News consumption (e.g. sharing of misinformation)', 'Social networks']",0,2,7,"Ethical approval provides protection for participants, and also helps to protect the researcher. ",Somewhat unacceptable,,,Somewhat acceptable,,,Completely acceptable,,,Neutral,,,Very important,Very important,Very important,Moderately important,Moderately important,Moderately important,Very important,Moderately important,Very important,not that i can think of right now  thank you,3.0,7.0,5.0,2.0,4.0,6.0,1.0,,,,,,
298,True,1291.0,Reddit,35.0,Male,White / Caucasian,Highschool,Slightly liberal,Not at all aware,"['… are large and can contain millions of data points', '… reflect events in real-time and can be collected continuously over time', '… are naturalistic in that they do not require researchers to directly interact with research volunteers', '… often capture social relationships not found using traditional methods (e.g. surveys)', '… are readily accessible to researchers and easy to collect']","['Privately messaging users', 'Creating fake accounts (""bots"")']","['Political elections (e.g. voting behavior)', 'Economic forecasting', 'Presidential approval ratings', 'Health topics (e.g. spread of diseases)', 'Well-being and economic satisfaction', 'Communication (e.g. spread of opinions and hate-speech)', 'Public sentiment (e.g. environment-related concerns)', 'News consumption (e.g. sharing of misinformation)', 'Social networks']",3,2,9,I'm guessing researchers can't do something that would harm users and if they deceive users they'd have to notify them about the deception afterwards.,Completely acceptable,,,Completely acceptable,only monitoring the users for 24 hours afterwards feels a little short but i don't have any problem with this,,Somewhat acceptable,"the only thing i really find objectionable about this is that the users were offered $5, a chance at $200, or a copy of the study results i feel like the study results should've been offered regardless otherwise i don't really have a problem with what they did",,Completely acceptable,,,Not at all important,Not at all important,Not at all important,Moderately important,Not at all important,Moderately important,Not at all important,Not at all important,Not at all important,not really i feel like given that this is public social media pretty much anything goes short of harassment,4.0,7.0,6.0,1.0,2.0,5.0,3.0,,,,,,
299,True,888.0,Reddit,26.0,Male,White / Caucasian,Highschool,Very liberal,Very aware,"['… are large and can contain millions of data points', '… reflect events in real-time and can be collected continuously over time', '… are naturalistic in that they do not require researchers to directly interact with research volunteers', '… often capture social relationships not found using traditional methods (e.g. surveys)', '… are readily accessible to researchers and easy to collect']","['Privately messaging users', 'Creating fake accounts (""bots"")']","['Political elections (e.g. voting behavior)', 'Economic forecasting', 'Presidential approval ratings', 'Health topics (e.g. spread of diseases)', 'Well-being and economic satisfaction', 'Communication (e.g. spread of opinions and hate-speech)', 'Public sentiment (e.g. environment-related concerns)', 'News consumption (e.g. sharing of misinformation)', 'Social networks']",3,2,9,"I think in this context 'ethical approval' would mean that the experiment causes no harm to the platform such as twitter, reddit, or to the users of these platforms",Neutral,my only concern is that the users were not told they were being studied,i'd like to know how long did the researchers use these anonymous accounts for,Neutral,"i don't really have any huge concerns, perhaps the researchers could've let the people know they were being studied",,Somewhat acceptable,,i'd like to know how they can make sure the browser extension only stays on peoples browsers for 8 weeks does the user have to remove it themselves? some people are not so great with technology and wouldn't be able to figure it out and thus the researchers could collect far more data than promised,Neutral,i have two concerns one being that the users were not told they were being studied two being that the users did not know they weren't interacting with an actual human,i'd like to know how long these automated accounts were active for,Very important,Slightly important,Very important,Very important,Moderately important,Very important,Extremely important,Slightly important,Extremely important,"in general my main concern was how the research may impact someone some people are fearful of ai so if you have an ai message someone without them knowing it's kind of wrong, in reality it causes no harm, but they may be upsetadditionally not allowing people to know they're being studied is unfair to those individuals this is generally what i based my opinions on",7.0,2.0,6.0,4.0,1.0,5.0,3.0,,,,,,
300,True,916.0,Reddit,50.0,Male,White / Caucasian,Highschool,Slightly conservative,Slightly aware,"['… reflect events in real-time and can be collected continuously over time', '… are readily accessible to researchers and easy to collect']","['Privately messaging users', 'Creating fake accounts (""bots"")']","['Political elections (e.g. voting behavior)', 'Economic forecasting', 'Presidential approval ratings', 'Public sentiment (e.g. environment-related concerns)']",0,2,4,I would think that this means that the experiment that they are running wouldn't break any laws or go against the norm of what people believe.,Completely acceptable,,,Somewhat acceptable,,,Neutral,,,Completely acceptable,,,Very important,Moderately important,Very important,Very important,Very important,Very important,Slightly important,Extremely important,Extremely important,"i think its important to make sure that there is a variety of people chosen, not just a fixed group",7.0,6.0,4.0,3.0,2.0,5.0,1.0,None,1.0,,,,
301,True,654.0,Twitter,29.0,Female,Mixed race,Bachelor's degree,Very liberal,Slightly aware,"['… reflect events in real-time and can be collected continuously over time', '… often capture social relationships not found using traditional methods (e.g. surveys)']","['Privately messaging users', ""Publicly posting on users' profiles"", 'Creating fake accounts (""bots"")']","['Communication (e.g. spread of opinions and hate-speech)', 'Public sentiment (e.g. environment-related concerns)', 'News consumption (e.g. sharing of misinformation)', 'Social networks']",2,3,4,I think ethical approval means getting the approval that their research will not do any harm. It has to be morally acceptable and not hurt anybody in the process especially if they are misleading people.,Completely acceptable,,,Completely acceptable,,,Somewhat acceptable,,,Completely acceptable,,,Very important,Not at all important,Moderately important,Not at all important,Slightly important,Moderately important,Moderately important,Moderately important,Very important,,7.0,5.0,6.0,4.0,1.0,3.0,2.0,,,,,,
302,True,1055.0,Twitter,65.0,Male,White / Caucasian,Highschool,Slightly conservative,Moderately aware,['… often capture social relationships not found using traditional methods (e.g. surveys)'],"[""Publicly posting on users' profiles""]","['Presidential approval ratings', 'Public sentiment (e.g. environment-related concerns)', 'News consumption (e.g. sharing of misinformation)']",1,1,3,It means that their surveys are ethical. The is they are free from bias or racial data.,Somewhat unacceptable,,,Completely unacceptable,,None,Somewhat unacceptable,,,Neutral,,,Not at all important,Not at all important,Slightly important,Not at all important,Not at all important,Not at all important,Not at all important,Not at all important,Not at all important,,7.0,2.0,5.0,3.0,4.0,6.0,1.0,,,,,,
303,True,635.0,Twitter,28.0,Female,African-American,Bachelor's degree,Slightly liberal,Very aware,"['… are large and can contain millions of data points', '… reflect events in real-time and can be collected continuously over time', '… are naturalistic in that they do not require researchers to directly interact with research volunteers', '… often capture social relationships not found using traditional methods (e.g. surveys)', '… are readily accessible to researchers and easy to collect']","['Privately messaging users', 'Creating fake accounts (""bots"")']","['Economic forecasting', 'Presidential approval ratings', 'Well-being and economic satisfaction', 'Communication (e.g. spread of opinions and hate-speech)', 'Public sentiment (e.g. environment-related concerns)', 'Social networks']",3,2,6,ethical approval means that the researcher is not allowed to do anything that may be construed as unethical by the general public,Somewhat acceptable,,,Somewhat acceptable,,,Somewhat acceptable,,,Neutral,,,Slightly important,Moderately important,Very important,Slightly important,Very important,Moderately important,Slightly important,Very important,Moderately important,,5.0,6.0,7.0,1.0,4.0,3.0,2.0,,8.0,,9.0,,10.0
304,True,999.0,Reddit,35.0,Male,White / Caucasian,Associate's degree,Slightly liberal,Slightly aware,"['… are large and can contain millions of data points', '… reflect events in real-time and can be collected continuously over time', '… are naturalistic in that they do not require researchers to directly interact with research volunteers', '… often capture social relationships not found using traditional methods (e.g. surveys)', '… are readily accessible to researchers and easy to collect']","['Privately messaging users', ""Publicly posting on users' profiles"", 'Creating fake accounts (""bots"")', 'Secretly changing the content of what users see']","['Political elections (e.g. voting behavior)', 'Economic forecasting', 'Presidential approval ratings', 'Health topics (e.g. spread of diseases)', 'Well-being and economic satisfaction', 'Communication (e.g. spread of opinions and hate-speech)', 'Public sentiment (e.g. environment-related concerns)', 'News consumption (e.g. sharing of misinformation)', 'Social networks']",3,2,9,"I think it generally means that by going through with the research that no one will be hurt in anyway, mistreated, or manipulated in a way that produces harm to others.",Completely acceptable,"kind of surprising results, one tends to think they know they are posting hateful things in the first place",,Completely acceptable,,,Completely acceptable,,,Completely acceptable,,,Not at all important,Very important,Not at all important,Not at all important,Not at all important,Slightly important,Not at all important,Slightly important,Not at all important,"not really, i don't have much concern about research as i like researched data in almost any capacity",4.0,7.0,3.0,5.0,2.0,6.0,1.0,,,,,,
305,True,644.0,Twitter,23.0,Female,White / Caucasian,Bachelor's degree,Very liberal,Moderately aware,"['… are large and can contain millions of data points', '… reflect events in real-time and can be collected continuously over time', '… are naturalistic in that they do not require researchers to directly interact with research volunteers', '… are readily accessible to researchers and easy to collect']","['Creating fake accounts (""bots"")', 'Secretly changing the content of what users see']","['Political elections (e.g. voting behavior)', 'Economic forecasting', 'Presidential approval ratings', 'Health topics (e.g. spread of diseases)', 'Well-being and economic satisfaction', 'Communication (e.g. spread of opinions and hate-speech)', 'Public sentiment (e.g. environment-related concerns)', 'News consumption (e.g. sharing of misinformation)', 'Social networks']",2,0,9,Ethical approval is making sure that no harm will be brought to participants. ,Completely acceptable,"i think this is acceptable because no harm was being brought to people by replying to tweets and if they had known they were being a subject in a study, it would have changed the organic results","i would want to see what they were replying to the hate speech, if it was harassing at all",Somewhat unacceptable,i believe that participants should know if they are being studied,,Completely acceptable,,,Somewhat unacceptable,i believe that participants should be aware that they are participating in a study,i would want to see how they replied to the participants that made them double down so much,Slightly important,Extremely important,Moderately important,Very important,Slightly important,Very important,Extremely important,Moderately important,Moderately important,"no, there are no other aspects that i can think of",7.0,2.0,5.0,3.0,1.0,6.0,4.0,,1.0,,2.0,,3.0
306,True,1203.0,Facebook,61.0,Male,White / Caucasian,Bachelor's degree,Slightly conservative,Slightly aware,"['… are large and can contain millions of data points', '… are readily accessible to researchers and easy to collect']",['None of the above'],"['Political elections (e.g. voting behavior)', 'Economic forecasting', 'Presidential approval ratings', 'Health topics (e.g. spread of diseases)', 'News consumption (e.g. sharing of misinformation)']",0,0,5,"To approve the study and that it relates to what is being studied.  They ask questions on what data is to be used and how that data will be attained.
",Somewhat acceptable,this might have certain bias because depending on the subject replies might not be true,"the object is to be objective, so no",Somewhat acceptable,why is it that only politically conservative websites are rated as untrustworthy?  i see a ton of news that is from liberal news sites that isn't correct  for example the hunter biden laptop before the election,this is extremely bias method since fact checkers are only looking at politically conservative websites,Completely acceptable,the thought that people willing allowed the following on facebook and tracking of visiting new websites,,Somewhat acceptable,i have found that fact checkers aren't concerned with the tone or verbage in a tweet but have biases that aren't included in the message,the biased that fact checkers have on only conserative speech  librail speech is last checked and news is only slanted as true if it comes from msnbc or cnn,Moderately important,Not at all important,Very important,Not at all important,Slightly important,Moderately important,Extremely important,Moderately important,Very important,mainly that individuals were not told of the study and tracked by the research,7.0,1.0,5.0,3.0,2.0,4.0,6.0,,,,,,
307,True,462.0,Twitter,32.0,Male,White / Caucasian,Bachelor's degree,Very liberal,Very aware,"['… are large and can contain millions of data points', '… reflect events in real-time and can be collected continuously over time', '… are naturalistic in that they do not require researchers to directly interact with research volunteers', '… often capture social relationships not found using traditional methods (e.g. surveys)', '… are readily accessible to researchers and easy to collect']","['Privately messaging users', ""Publicly posting on users' profiles"", 'Creating fake accounts (""bots"")']","['Political elections (e.g. voting behavior)', 'Economic forecasting', 'Presidential approval ratings', 'Health topics (e.g. spread of diseases)', 'Well-being and economic satisfaction', 'Communication (e.g. spread of opinions and hate-speech)', 'Public sentiment (e.g. environment-related concerns)', 'News consumption (e.g. sharing of misinformation)', 'Social networks']",3,3,9,I think it means being allowed to gather information via social media because there are often privacy concerns associated with it. ,Somewhat acceptable,there's some trickery involved but it's not substantial,what kinds of posts did the anonymous accounts send,Completely acceptable,,,Neutral,installing a browser extension that monitors the sites you visit and posts viewed could be a privacy violation,i'd like to know more specifics regarding what the researchers were able to see,Completely acceptable,,,Very important,Slightly important,Moderately important,Very important,Moderately important,Very important,Very important,Moderately important,Extremely important,,7.0,1.0,3.0,2.0,6.0,5.0,4.0,,,,,,
308,True,429.0,Twitter,29.0,Male,Hispanic,Master's degree or above,Slightly liberal,Moderately aware,"['… are large and can contain millions of data points', '… reflect events in real-time and can be collected continuously over time', '… often capture social relationships not found using traditional methods (e.g. surveys)', '… are readily accessible to researchers and easy to collect']","['Privately messaging users', ""Publicly posting on users' profiles""]","['Political elections (e.g. voting behavior)', 'Economic forecasting', 'Presidential approval ratings', 'Health topics (e.g. spread of diseases)', 'Well-being and economic satisfaction', 'Communication (e.g. spread of opinions and hate-speech)', 'Public sentiment (e.g. environment-related concerns)', 'News consumption (e.g. sharing of misinformation)', 'Social networks']",2,2,9,They need approval from their institutions so that the institutions are aware of what will be done and ensure that it is done in a legal manner that doesn't harm the subjects involved. ,Somewhat unacceptable,,,Somewhat unacceptable,"users should be made aware that they are being used in a study i'm sure if they were aware, they would not post or say certain things",,Completely acceptable,,,Somewhat unacceptable,the users should have been aware that they were part of a study they didn't get consent for their data to be used,,Moderately important,Moderately important,Moderately important,Very important,Moderately important,Moderately important,Extremely important,Moderately important,Moderately important,i think the list above are important i can't think of anything else,7.0,2.0,5.0,1.0,4.0,6.0,3.0,,,,,,
309,True,1143.0,Facebook,66.0,Female,White / Caucasian,Master's degree or above,Very conservative,Not at all aware,"['… are naturalistic in that they do not require researchers to directly interact with research volunteers', '… often capture social relationships not found using traditional methods (e.g. surveys)', '… are readily accessible to researchers and easy to collect']","['Creating fake accounts (""bots"")']","['Health topics (e.g. spread of diseases)', 'Public sentiment (e.g. environment-related concerns)', 'News consumption (e.g. sharing of misinformation)']",1,1,3,There might be a panel of peers who have to approve the study. ,Completely acceptable,there were no consequences and the test was on what was already presented on the site,,Somewhat unacceptable,i think it could be done more ethically with more honesty,,Completely acceptable,it seems that they were upfront about what they were doing and the person who was being tested would know what was going on,i think it would be nice if there was a place to comment or make a complaint about the study if the person being tested want to do that,Completely unacceptable,fake accounts and people unaware of what is going on does not seem ethical to me,i think it has to be truthful and people could opt in or out,Very important,Extremely important,Moderately important,Moderately important,Slightly important,Very important,Extremely important,Extremely important,Slightly important,,7.0,2.0,5.0,4.0,3.0,6.0,1.0,None,4.0,None,5.0,,
310,True,1137.0,Twitter,19.0,Male,White / Caucasian,Highschool,Very liberal,Very aware,"['… are large and can contain millions of data points', '… reflect events in real-time and can be collected continuously over time', '… are naturalistic in that they do not require researchers to directly interact with research volunteers', '… often capture social relationships not found using traditional methods (e.g. surveys)', '… are readily accessible to researchers and easy to collect']","['Privately messaging users', ""Publicly posting on users' profiles""]","['Political elections (e.g. voting behavior)', 'Presidential approval ratings', 'Well-being and economic satisfaction', 'Communication (e.g. spread of opinions and hate-speech)', 'Public sentiment (e.g. environment-related concerns)', 'News consumption (e.g. sharing of misinformation)', 'Social networks']",3,2,7,Their institution needs to believe that they are acting ethically in their data collection practices ,Completely acceptable,"this is fully acceptable, the researchers were simply viewing public data",,Completely acceptable,"i find it completely ethically acceptable, all that was done was message public accounts, which is a right of anyone on the platform",,Completely acceptable,"you got clear consent, informed the participants of what the study is, and offered a reward, fully ethically acceptable",,Somewhat acceptable,"i still find it acceptable because they're just utilizing a public forum as intended, although i do prefer the use of humans rather than bots during these studies as the human can better tailor the message to the recipient allowing for better data to be found",,Very important,Slightly important,Extremely important,Very important,Extremely important,Slightly important,Slightly important,Moderately important,Moderately important,i prefer a human do it rather than automated bots,7.0,6.0,3.0,5.0,1.0,4.0,2.0,,,,,,
311,True,682.0,Facebook,59.0,Male,White / Caucasian,Bachelor's degree,Slightly conservative,Slightly aware,['… reflect events in real-time and can be collected continuously over time'],"[""Publicly posting on users' profiles"", 'Creating fake accounts (""bots"")']","['Economic forecasting', 'Presidential approval ratings', 'Public sentiment (e.g. environment-related concerns)', 'News consumption (e.g. sharing of misinformation)']",1,2,4,No emotional harm done???,Somewhat acceptable,,,Completely acceptable,,,Somewhat acceptable,,,Completely unacceptable,"professional fact ""checkers"" ??? you mean propaganda workers",,Slightly important,Not at all important,Not at all important,Slightly important,Not at all important,Slightly important,Not at all important,Slightly important,Slightly important,"no at the end of the day, it changes nothing in real life",7.0,5.0,3.0,6.0,2.0,4.0,1.0,,,,,,
312,True,504.0,Twitter,34.0,Male,White / Caucasian,Bachelor's degree,Slightly conservative,Very aware,"['… are large and can contain millions of data points', '… reflect events in real-time and can be collected continuously over time', '… are naturalistic in that they do not require researchers to directly interact with research volunteers', '… often capture social relationships not found using traditional methods (e.g. surveys)', '… are readily accessible to researchers and easy to collect', '… are unaffected by the way social media platforms work']","['Privately messaging users', ""Publicly posting on users' profiles"", 'Creating fake accounts (""bots"")', 'Secretly changing the content of what users see']","['Political elections (e.g. voting behavior)', 'Economic forecasting', 'Presidential approval ratings', 'Health topics (e.g. spread of diseases)', 'Well-being and economic satisfaction', 'Communication (e.g. spread of opinions and hate-speech)', 'Public sentiment (e.g. environment-related concerns)', 'News consumption (e.g. sharing of misinformation)', 'Social networks']",2,2,9,"I think they submit a form detailing what they are planning on researching, how they plan on going about that, and the effect the research will have on those they are researching. The institution then determines if the possible academic gain is worth any damage to the public.",Completely acceptable,,,Somewhat acceptable,the participants should have been made aware that they were part of a study at some point,,Completely acceptable,,,Somewhat acceptable,i would have liked the participants to be made away they were part of the study at some point,,Very important,Very important,Very important,Moderately important,Slightly important,Very important,Extremely important,Extremely important,Moderately important,,2.0,4.0,7.0,5.0,1.0,3.0,6.0,,,,,,
313,True,1623.0,Twitter,29.0,Male,African-American,Bachelor's degree,Slightly conservative,Very aware,"['… are large and can contain millions of data points', '… reflect events in real-time and can be collected continuously over time', '… are readily accessible to researchers and easy to collect']","['Creating fake accounts (""bots"")']","['Political elections (e.g. voting behavior)', 'Economic forecasting', 'Health topics (e.g. spread of diseases)', 'Well-being and economic satisfaction', 'Communication (e.g. spread of opinions and hate-speech)', 'Public sentiment (e.g. environment-related concerns)', 'News consumption (e.g. sharing of misinformation)', 'Social networks']",1,1,8,Ethical approval is said to be the acceptance of ethical levels of an authentic research study by the researcher,Somewhat unacceptable,,,Completely unacceptable,participants have the right to who has access to their data,,Completely acceptable,,,Somewhat unacceptable,,,Very important,Very important,Very important,Very important,Moderately important,Very important,Very important,Moderately important,Very important,participant awareness is very important  to me because i think i should know who views or has access to my data,4.0,1.0,6.0,7.0,3.0,5.0,2.0,,,,,,
314,True,754.0,Facebook,73.0,Female,White / Caucasian,Bachelor's degree,Neutral/ Neither conservative or liberal,Not at all aware,"['… reflect events in real-time and can be collected continuously over time', '… often capture social relationships not found using traditional methods (e.g. surveys)', '… are readily accessible to researchers and easy to collect']","['Creating fake accounts (""bots"")']","['Political elections (e.g. voting behavior)', 'Communication (e.g. spread of opinions and hate-speech)', 'News consumption (e.g. sharing of misinformation)', 'Social networks']",1,1,4,They go by accepted standards assigned to research studies,Somewhat acceptable,,,Somewhat acceptable,,,Completely acceptable,,,Somewhat acceptable,,,Very important,Very important,Very important,Moderately important,Very important,Moderately important,Very important,Very important,Very important,,3.0,4.0,2.0,1.0,6.0,7.0,5.0,,,,,,
315,True,405.0,Twitter,45.0,Male,White / Caucasian,Bachelor's degree,Very liberal,Very aware,"['… are large and can contain millions of data points', '… reflect events in real-time and can be collected continuously over time', '… are naturalistic in that they do not require researchers to directly interact with research volunteers', '… often capture social relationships not found using traditional methods (e.g. surveys)', '… are readily accessible to researchers and easy to collect']","['Privately messaging users', ""Publicly posting on users' profiles"", 'Creating fake accounts (""bots"")']","['Political elections (e.g. voting behavior)', 'Economic forecasting', 'Presidential approval ratings', 'Health topics (e.g. spread of diseases)', 'Well-being and economic satisfaction', 'Communication (e.g. spread of opinions and hate-speech)', 'Public sentiment (e.g. environment-related concerns)', 'News consumption (e.g. sharing of misinformation)', 'Social networks']",3,3,9,Approval that doesn't violate any norms or laws.,Somewhat acceptable,,,Somewhat unacceptable,,,Neutral,,,Somewhat acceptable,,,Slightly important,Slightly important,Not at all important,Very important,Moderately important,Moderately important,Very important,Slightly important,Not at all important,,4.0,3.0,7.0,6.0,2.0,5.0,1.0,,,,,,
316,True,928.0,Facebook,58.0,Female,White / Caucasian,Highschool,Slightly conservative,Not at all aware,['… often capture social relationships not found using traditional methods (e.g. surveys)'],['Privately messaging users'],"['Presidential approval ratings', 'Health topics (e.g. spread of diseases)', 'Communication (e.g. spread of opinions and hate-speech)', 'Public sentiment (e.g. environment-related concerns)', 'News consumption (e.g. sharing of misinformation)', 'Social networks']",1,1,6,It means that what they want to do does not break any rules and is morally acceptable.,Completely acceptable,,,Completely acceptable,,if they had known they were part of a study they may not have answered honestly,Completely acceptable,,,Completely acceptable,no concerns i think it was an interesting trial,no one was really mislead in any way any more than a normal day on twitter,Not at all important,Extremely important,Extremely important,Very important,Not at all important,Very important,Slightly important,Not at all important,Not at all important,"tracking concerns me a little, but as long as the data collected is generic and publicly posted, such as someone's thoughts on a subject, public domain is public domain, so have at it",4.0,7.0,5.0,3.0,1.0,6.0,2.0,,,,,,
317,True,355.0,Facebook,42.0,Non-binary / third gender,White / Caucasian,Highschool,Very liberal,Moderately aware,"['… reflect events in real-time and can be collected continuously over time', '… are naturalistic in that they do not require researchers to directly interact with research volunteers', '… often capture social relationships not found using traditional methods (e.g. surveys)', '… are readily accessible to researchers and easy to collect']","['Privately messaging users', ""Publicly posting on users' profiles""]","['Political elections (e.g. voting behavior)', 'Economic forecasting', 'Presidential approval ratings', 'Health topics (e.g. spread of diseases)', 'Well-being and economic satisfaction', 'Communication (e.g. spread of opinions and hate-speech)', 'Public sentiment (e.g. environment-related concerns)', 'News consumption (e.g. sharing of misinformation)', 'Social networks']",2,2,9,Getting permission from their professors and college staff for their research.,Completely acceptable,,,Completely acceptable,,,Completely acceptable,,,Completely acceptable,,,Moderately important,Moderately important,Very important,Very important,Moderately important,Moderately important,Not at all important,Extremely important,Extremely important,,4.0,3.0,5.0,2.0,6.0,7.0,1.0,,,,,,
318,True,1074.0,Facebook,59.0,Female,White / Caucasian,Highschool,Very liberal,Not at all aware,"['… are large and can contain millions of data points', '… reflect events in real-time and can be collected continuously over time', '… often capture social relationships not found using traditional methods (e.g. surveys)', '… are readily accessible to researchers and easy to collect']","['Privately messaging users', 'Creating fake accounts (""bots"")']","['Well-being and economic satisfaction', 'Communication (e.g. spread of opinions and hate-speech)', 'Public sentiment (e.g. environment-related concerns)', 'News consumption (e.g. sharing of misinformation)']",2,2,4,It means that the institution must have standards on which there is a moral basis to how and why the material is collected.,Somewhat acceptable,,,Completely acceptable,,,Completely acceptable,,,Completely acceptable,,,Slightly important,Not at all important,Not at all important,Not at all important,Not at all important,Slightly important,Slightly important,Not at all important,Slightly important,"none i can think of the only concern i would have is there was an obvious threat of mishandled private information, which i don't think would have been done",4.0,7.0,6.0,3.0,1.0,5.0,2.0,,,,,,
319,True,510.0,Facebook,28.0,Female,White / Caucasian,Bachelor's degree,Very liberal,Moderately aware,"['… reflect events in real-time and can be collected continuously over time', '… are naturalistic in that they do not require researchers to directly interact with research volunteers', '… often capture social relationships not found using traditional methods (e.g. surveys)']","['Creating fake accounts (""bots"")']","['Communication (e.g. spread of opinions and hate-speech)', 'Public sentiment (e.g. environment-related concerns)', 'News consumption (e.g. sharing of misinformation)', 'Social networks']",3,1,4,I believe that means they need to double-check that they're not going to offend the masses and get cancelled.,Somewhat acceptable,"the outcome created more good than it did bad, so i can't be too mad  that there is less hate speech online",,Somewhat unacceptable,"seems a little sneaky, which i don't like",,Somewhat acceptable,i think its ok seeing as the individuals realized they were taking part in a study,,Neutral,"once again, i do not like that the participants were not aware that they were taking part in a study even if the outcome means that they were more politically aware of the truth and corrected on their ill-informed information that they were sharing",,Moderately important,Very important,Very important,Very important,Very important,Moderately important,Extremely important,Extremely important,Moderately important,,4.0,1.0,7.0,2.0,3.0,6.0,5.0,,,,,,
320,True,790.0,Facebook,44.0,Female,White / Caucasian,Highschool,Very liberal,Not at all aware,"['… are large and can contain millions of data points', '… reflect events in real-time and can be collected continuously over time', '… are naturalistic in that they do not require researchers to directly interact with research volunteers', '… often capture social relationships not found using traditional methods (e.g. surveys)', '… are readily accessible to researchers and easy to collect']","['Creating fake accounts (""bots"")']","['Political elections (e.g. voting behavior)', 'Health topics (e.g. spread of diseases)']",3,1,2,"Ethical would be dealing with morals, or the principal of morality. It would have to be approved from their institution as having high moral ethics.",Completely acceptable,hate speech is tricky on social media we have free speech but we also have consequences,,Somewhat acceptable,i'm glad they shared higher quality posts,,Neutral,the gift card part makes me doubt the actual findings,,Completely acceptable,i like the fact checking post idea,i would have liked to see an actual example,Moderately important,Very important,Very important,Moderately important,Slightly important,Moderately important,Not at all important,Very important,Moderately important,,2.0,6.0,7.0,1.0,4.0,5.0,3.0,,7.0,,,,
321,True,911.0,Facebook,32.0,Female,Mixed race,Highschool,Very liberal,Very aware,"['… are large and can contain millions of data points', '… are naturalistic in that they do not require researchers to directly interact with research volunteers', '… often capture social relationships not found using traditional methods (e.g. surveys)', '… are readily accessible to researchers and easy to collect']",['None of the above'],"['Political elections (e.g. voting behavior)', 'Health topics (e.g. spread of diseases)', 'Social networks']",2,0,3,Something is morally right ,Completely acceptable,,,Somewhat acceptable,,,Neutral,,,Somewhat acceptable,the experiment seems that it did not have the intended effect,,Moderately important,Moderately important,Moderately important,Slightly important,Slightly important,Very important,Moderately important,Very important,Moderately important,,5.0,7.0,3.0,4.0,1.0,2.0,6.0,,,,,,
322,True,1020.0,Facebook,31.0,Female,White / Caucasian,Bachelor's degree,Very conservative,Not at all aware,"['… are large and can contain millions of data points', '… reflect events in real-time and can be collected continuously over time', '… are naturalistic in that they do not require researchers to directly interact with research volunteers', '… often capture social relationships not found using traditional methods (e.g. surveys)', '… are readily accessible to researchers and easy to collect']",['Privately messaging users'],"['Political elections (e.g. voting behavior)', 'Presidential approval ratings', 'Health topics (e.g. spread of diseases)', 'Well-being and economic satisfaction', 'Communication (e.g. spread of opinions and hate-speech)', 'News consumption (e.g. sharing of misinformation)', 'Social networks']",3,1,7,Ethical approval is something that they get from their institution saying that they are allowed to the the research and it is approved to do.,Completely acceptable,i find it acceptable because these people were posting hate speech and i think it was good that the study found them posting less hate speech afterwards  i think if someone has a public twitter you are free to reply and monitor what they post,,Somewhat acceptable,i think it is somewhat acceptable  it is a little intrusive to private message all these people though,,Completely acceptable,i like that they had told people ahead of time about the research  i feel like the pay was very low  i think the results are interesting,,Completely acceptable,i think it is acceptable because all they were doing were essentially telling them that what they posted was false and to see their reaction afterwards  i think it is harmless,,Extremely important,Slightly important,Extremely important,Very important,Slightly important,Extremely important,Moderately important,Extremely important,Extremely important,,5.0,4.0,6.0,1.0,7.0,3.0,2.0,,,,,,
323,True,1352.0,Facebook,65.0,Female,White / Caucasian,Master's degree or above,Very liberal,Moderately aware,"['… are large and can contain millions of data points', '… reflect events in real-time and can be collected continuously over time', '… are naturalistic in that they do not require researchers to directly interact with research volunteers', '… often capture social relationships not found using traditional methods (e.g. surveys)', '… are readily accessible to researchers and easy to collect']","['Creating fake accounts (""bots"")']","['Political elections (e.g. voting behavior)', 'Health topics (e.g. spread of diseases)', 'News consumption (e.g. sharing of misinformation)', 'Social networks']",3,1,4,I think that ethical approval means that the proposed research study has been evaluated by an oversight committee that follows a set of ethical guidelines for the administration of research studies.,Somewhat unacceptable,it would be one thing to analyze the results of actual human respondents to the hate posts to see if posts promoting empathy resulted in less hate speech i would find that acceptable i would also support conducting the experiment if the researchers had the participants' approval to participate in an experiment involving twitter posts (without going into detail) i think think this kind of sneaky manipulating social media to be unethical,,Completely acceptable,i don't have a problem with this experiment because the researchers are sending out the inquiries privately and the respondents may choose to rate the headline however they wish (or even if they want to participate),,Completely acceptable,the researchers had the informed consent of the participants,,Completely acceptable,i had thought this was being done routinely on social media i have no problem with questionable posts being identified with a reputable fact-checking website being provided so that individuals could start self monitoring the veracity of their posts,,Very important,Slightly important,Extremely important,Slightly important,Very important,Very important,Extremely important,Very important,Very important,,5.0,4.0,2.0,1.0,6.0,7.0,3.0,,,,,,
324,True,466.0,Facebook,46.0,Female,White / Caucasian,Bachelor's degree,Very conservative,Slightly aware,"['… often capture social relationships not found using traditional methods (e.g. surveys)', '… are unaffected by the way social media platforms work']","['Privately messaging users', ""Publicly posting on users' profiles""]","['Political elections (e.g. voting behavior)', 'Health topics (e.g. spread of diseases)']",0,2,2,What they think is acceptable behavior by most of those around them.  ,Somewhat unacceptable,it is not right that they used fake accounts and misinformed the people about stuff they robotically responded with,,Neutral,,,Somewhat acceptable,,,Completely unacceptable,,,Very important,Moderately important,Slightly important,Slightly important,Not at all important,Slightly important,Very important,Slightly important,Moderately important,i really didn't know that this was happening  i do occasionally see random things on social media and i just ignore them since they have to do with politics,7.0,2.0,3.0,4.0,5.0,6.0,1.0,,1.0,,2.0,,3.0
325,True,692.0,Twitter,50.0,Female,White / Caucasian,Master's degree or above,Slightly liberal,Slightly aware,"['… are large and can contain millions of data points', '… reflect events in real-time and can be collected continuously over time', '… are naturalistic in that they do not require researchers to directly interact with research volunteers', '… often capture social relationships not found using traditional methods (e.g. surveys)', '… are readily accessible to researchers and easy to collect']","['Privately messaging users', ""Publicly posting on users' profiles""]","['Political elections (e.g. voting behavior)', 'Health topics (e.g. spread of diseases)', 'Well-being and economic satisfaction', 'Communication (e.g. spread of opinions and hate-speech)', 'Public sentiment (e.g. environment-related concerns)', 'News consumption (e.g. sharing of misinformation)', 'Social networks']",3,2,7,That they are not doing something that could result in harm to others,Somewhat acceptable,,the fact that they did not post hate speech themselves and actually promoted empathy made it reasonable to me,Somewhat acceptable,it feels like the researchers should have disclosed that they were doing research,i would want to see an example of a message they sent,Somewhat acceptable,my only concern is when people are paid to like or follow a site - that manipulates the popularity of a site but otherwise the people consented to take part in the research,,Completely acceptable,they were actually providing a useful service so it seemed ok,,Slightly important,Not at all important,Moderately important,Slightly important,Not at all important,Extremely important,Very important,Moderately important,Not at all important,yes - if there is any manipulation,5.0,4.0,7.0,3.0,1.0,6.0,2.0,avoid putting out false information,3.0,,,,
326,True,1304.0,Facebook,55.0,Female,White / Caucasian,Highschool,Slightly conservative,Moderately aware,"['… are large and can contain millions of data points', '… reflect events in real-time and can be collected continuously over time', '… are naturalistic in that they do not require researchers to directly interact with research volunteers', '… often capture social relationships not found using traditional methods (e.g. surveys)', '… are readily accessible to researchers and easy to collect']","['Privately messaging users', 'Creating fake accounts (""bots"")', 'Secretly changing the content of what users see']","['Political elections (e.g. voting behavior)', 'Economic forecasting', 'Presidential approval ratings', 'Health topics (e.g. spread of diseases)', 'Well-being and economic satisfaction', 'Communication (e.g. spread of opinions and hate-speech)', 'Public sentiment (e.g. environment-related concerns)', 'News consumption (e.g. sharing of misinformation)', 'Social networks']",3,1,9,Ethical approval I think would mean if the way information is collected is truly honest and transparent. ,Neutral,i love the results of this study and that hate speech was decreased and in some cases deleted,,Neutral,it was done with an anonymous created account which is of concern however i can see it was needed to get true data,no i don’t think so because any more information would change the research,Completely acceptable,they had knowledge and a choice of participating,i do find it interesting that people visited the opposing party site i think we all look at others differently when we truly know more about them,Neutral,this study seemed to cause more negative reactions instead of helping,,Very important,Moderately important,Extremely important,Very important,Moderately important,Moderately important,Extremely important,Very important,Very important,no everything seems to be covered above,6.0,1.0,4.0,2.0,7.0,5.0,3.0,,,,,,
327,True,711.0,Reddit,44.0,Male,Mixed race,Bachelor's degree,Neutral/ Neither conservative or liberal,Moderately aware,"['… are large and can contain millions of data points', '… often capture social relationships not found using traditional methods (e.g. surveys)', '… are readily accessible to researchers and easy to collect']","['Creating fake accounts (""bots"")', 'Secretly changing the content of what users see']","['Political elections (e.g. voting behavior)', 'Economic forecasting', 'Presidential approval ratings', 'Well-being and economic satisfaction', 'Communication (e.g. spread of opinions and hate-speech)', 'Public sentiment (e.g. environment-related concerns)', 'News consumption (e.g. sharing of misinformation)', 'Social networks']",1,0,8,ethical approval would be getting approval from their institution that what they are using their research for (unknown to the user) is being used ethically,Somewhat acceptable,,,Neutral,why didn't they also identify and include left leaning people?,if they had run the same experiment with left leaning people,Somewhat acceptable,"since the participants opted in, seems ethical to me",,Somewhat acceptable,"even though they used bots, the information they used was still factual",,Very important,Not at all important,Moderately important,Slightly important,Not at all important,Slightly important,Slightly important,Moderately important,Very important,,6.0,5.0,3.0,1.0,4.0,7.0,2.0,"inclusion of all sides (far right, far left, moderate) when it comes to research on things like hate speech and false information",7.0,,,,
328,True,535.0,Facebook,43.0,Male,White / Caucasian,Associate's degree,Neutral/ Neither conservative or liberal,Very aware,"['… are large and can contain millions of data points', '… reflect events in real-time and can be collected continuously over time', '… are naturalistic in that they do not require researchers to directly interact with research volunteers', '… often capture social relationships not found using traditional methods (e.g. surveys)', '… are readily accessible to researchers and easy to collect']","['Privately messaging users', 'Secretly changing the content of what users see']","['Political elections (e.g. voting behavior)', 'Presidential approval ratings', 'Health topics (e.g. spread of diseases)', 'Well-being and economic satisfaction', 'Communication (e.g. spread of opinions and hate-speech)', 'Public sentiment (e.g. environment-related concerns)', 'News consumption (e.g. sharing of misinformation)']",3,0,7,"They need to be up front about what they are planning on collecting, how they are going to collect it, and what they are going to use the data they collect for. The participants need to know exactly what they are submitting to, and why.",Somewhat acceptable,,,Completely acceptable,,,Completely acceptable,,,Somewhat unacceptable,"the way they presented this one was more of a direct challenge to the people who were spreading misinformation, than a gentle push in the right direction this caused them to dig in and become more toxic",,Extremely important,Very important,Extremely important,Extremely important,Extremely important,Slightly important,Very important,Moderately important,Extremely important,,3.0,4.0,6.0,2.0,5.0,7.0,1.0,,,,,,
329,True,734.0,Twitter,32.0,Female,African-American,Master's degree or above,Very liberal,Very aware,"['… are large and can contain millions of data points', '… reflect events in real-time and can be collected continuously over time', '… are naturalistic in that they do not require researchers to directly interact with research volunteers', '… often capture social relationships not found using traditional methods (e.g. surveys)', '… are readily accessible to researchers and easy to collect']","[""Publicly posting on users' profiles"", 'Creating fake accounts (""bots"")']","['Political elections (e.g. voting behavior)', 'Health topics (e.g. spread of diseases)', 'Communication (e.g. spread of opinions and hate-speech)', 'Public sentiment (e.g. environment-related concerns)', 'News consumption (e.g. sharing of misinformation)']",3,2,5,That they are going to use the information they receive appropriately. They are not going to manipulate and misuse what they gather.,Completely unacceptable,i don't think it should be right to use participants in studies without their knowledge,,Completely unacceptable,deception should never be used where someone's information is used without them knowing,,Completely unacceptable,i don't think it's right to have people like like facebook pages esp for compensation,i think they could have created a fake facebook interface but not use the actual facebook,Completely unacceptable,i don't think they should be using people in a study and they do not know,,Very important,Slightly important,Moderately important,Slightly important,Slightly important,Very important,Extremely important,Extremely important,Very important,,7.0,1.0,3.0,2.0,5.0,4.0,6.0,,,,,,
330,True,1307.0,Facebook,37.0,Male,White / Caucasian,Highschool,Slightly liberal,Very aware,"['… are large and can contain millions of data points', '… are naturalistic in that they do not require researchers to directly interact with research volunteers', '… often capture social relationships not found using traditional methods (e.g. surveys)', '… are readily accessible to researchers and easy to collect']","['Privately messaging users', ""Publicly posting on users' profiles"", 'Creating fake accounts (""bots"")', 'Secretly changing the content of what users see']","['Political elections (e.g. voting behavior)', 'Economic forecasting', 'Presidential approval ratings', 'Health topics (e.g. spread of diseases)', 'Well-being and economic satisfaction', 'Public sentiment (e.g. environment-related concerns)', 'News consumption (e.g. sharing of misinformation)', 'Social networks']",2,2,8,"Probably has to do with disclosure identifiable information of the people used to gather the data.  Also, ensuring that the study doesn't negatively impact society.",Somewhat unacceptable,,i do not like that they used actual human accounts with real (non automated) messages,Completely acceptable,i don't think it was unethical at all  it likely made those people stop and think about what sort of information they are sharing with others,"if any of the information was publicly shared, like on the end users' public profile, then i would not agree with that",Completely acceptable,"interesting that being exposed to oppositional beliefs, these people accepted them more",if they used or sold more information from the browser extension than they led on,Neutral,"some people, even when confronted with facts, will dig in and become hostile when their views are questioned",,Moderately important,Very important,Very important,Very important,Extremely important,Slightly important,Extremely important,Very important,Slightly important,,7.0,2.0,5.0,3.0,1.0,6.0,4.0,,,,,,
331,True,1431.0,Twitter,60.0,Male,White / Caucasian,Bachelor's degree,Slightly liberal,Slightly aware,"['… are large and can contain millions of data points', '… reflect events in real-time and can be collected continuously over time', '… are naturalistic in that they do not require researchers to directly interact with research volunteers', '… often capture social relationships not found using traditional methods (e.g. surveys)', '… are readily accessible to researchers and easy to collect']","[""Publicly posting on users' profiles"", 'Creating fake accounts (""bots"")']","['Political elections (e.g. voting behavior)', 'Presidential approval ratings', 'Health topics (e.g. spread of diseases)', 'Well-being and economic satisfaction', 'Communication (e.g. spread of opinions and hate-speech)', 'Public sentiment (e.g. environment-related concerns)', 'News consumption (e.g. sharing of misinformation)', 'Social networks']",3,2,8,That their research will not cause harm to the subjects.,Completely acceptable,while deceptive i see no harm to anyone,,Completely acceptable,the message is private but seems harmless to me,,Completely acceptable,although intrusive it is conducted with the consent of the participants so i see no problem,,Completely acceptable,,,Moderately important,Not at all important,Not at all important,Not at all important,Slightly important,Slightly important,Moderately important,Slightly important,Moderately important,,5.0,7.0,6.0,2.0,1.0,4.0,3.0,,,,,,
332,True,702.0,Facebook,62.0,Female,White / Caucasian,Master's degree or above,Neutral/ Neither conservative or liberal,Extremely aware,"['… are large and can contain millions of data points', '… reflect events in real-time and can be collected continuously over time', '… are naturalistic in that they do not require researchers to directly interact with research volunteers', '… often capture social relationships not found using traditional methods (e.g. surveys)', '… are readily accessible to researchers and easy to collect']","['Creating fake accounts (""bots"")']","['Communication (e.g. spread of opinions and hate-speech)', 'News consumption (e.g. sharing of misinformation)', 'Social networks']",3,1,3,"That before they do any experiments, they receive approval from the institution for which they work.  For example, they work for Duke University.  Duke University would have a committee that would approve what they are doing and how ethical the research is before starting.",Somewhat unacceptable,"because the participants were unaware, i feel this is less ethical",,Completely acceptable,,,Completely acceptable,,,Neutral,"this does not sound unethical, but i still don't like that participants were unaware",,Very important,Very important,Extremely important,Extremely important,Moderately important,Extremely important,Extremely important,Extremely important,Extremely important,,5.0,1.0,6.0,2.0,4.0,7.0,3.0,,,,,,
333,True,969.0,Facebook,46.0,Female,African-American,Bachelor's degree,Neutral/ Neither conservative or liberal,Moderately aware,"['… are large and can contain millions of data points', '… reflect events in real-time and can be collected continuously over time', '… often capture social relationships not found using traditional methods (e.g. surveys)', '… are readily accessible to researchers and easy to collect']","['Privately messaging users', ""Publicly posting on users' profiles"", 'Creating fake accounts (""bots"")']","['Political elections (e.g. voting behavior)', 'Economic forecasting', 'Presidential approval ratings', 'Health topics (e.g. spread of diseases)', 'Well-being and economic satisfaction', 'Communication (e.g. spread of opinions and hate-speech)', 'Public sentiment (e.g. environment-related concerns)', 'News consumption (e.g. sharing of misinformation)', 'Social networks']",2,3,9,when participants have the right to know who has access to their data.,Somewhat acceptable,"even though   twitter users did not know about the research studies, the outcome was good for everyone",,Neutral,,,Neutral,,,Completely unacceptable,,,Slightly important,Slightly important,Moderately important,Very important,Moderately important,Moderately important,Slightly important,Slightly important,Very important,,5.0,1.0,7.0,4.0,2.0,6.0,3.0,,0.0,,0.0,,0.0
334,True,1665.0,Facebook,62.0,Female,White / Caucasian,Bachelor's degree,Very liberal,Slightly aware,"['… are large and can contain millions of data points', '… reflect events in real-time and can be collected continuously over time', '… are naturalistic in that they do not require researchers to directly interact with research volunteers', '… often capture social relationships not found using traditional methods (e.g. surveys)', '… are readily accessible to researchers and easy to collect']",['None of the above'],"['Political elections (e.g. voting behavior)', 'Economic forecasting', 'Presidential approval ratings', 'Health topics (e.g. spread of diseases)', 'Well-being and economic satisfaction', 'Communication (e.g. spread of opinions and hate-speech)', 'Public sentiment (e.g. environment-related concerns)', 'News consumption (e.g. sharing of misinformation)', 'Social networks']",3,0,9,To make sure that the experiments would cause no harm to anyone.,Somewhat acceptable,"i really don't have any problems with the study no harm was done, although participants were not aware that the accounts were anonymous, and that they were taking part in research however, i feel it had to be done this way in order to get accurate assessments",,Completely acceptable,"because of the nature of the research and the information that was needed, i have no problem with this no harm was done",,Completely acceptable,,,Completely acceptable,"again, because of the intent of the research, i find this acceptable",,Extremely important,Extremely important,Extremely important,Slightly important,Extremely important,Extremely important,Extremely important,Extremely important,Extremely important,"my only concern would that the research would collect confidential data about an individual from the way these experiments were described, it didn't appear that they did",7.0,5.0,6.0,2.0,1.0,3.0,4.0,,,,,,
335,True,875.0,Twitter,26.0,Male,Hispanic,Highschool,Neutral/ Neither conservative or liberal,Very aware,"['… are large and can contain millions of data points', '… reflect events in real-time and can be collected continuously over time', '… are naturalistic in that they do not require researchers to directly interact with research volunteers', '… often capture social relationships not found using traditional methods (e.g. surveys)', '… are readily accessible to researchers and easy to collect']",['Secretly changing the content of what users see'],"['Health topics (e.g. spread of diseases)', 'Well-being and economic satisfaction', 'Communication (e.g. spread of opinions and hate-speech)', 'Public sentiment (e.g. environment-related concerns)', 'News consumption (e.g. sharing of misinformation)', 'Social networks']",3,-1,6,Accepting something that is morally right in some ways,Somewhat acceptable,this is one of those scenarios where consent isn't needed if you're acting like an awful human being i believe it's fair to study their behavior as to why they act that way,,Somewhat unacceptable,researchers should not contact random people without their consent to the study,,Neutral,,,Neutral,i think this is okay it can be dangerous to spread misinformation,,Extremely important,Moderately important,Extremely important,Extremely important,Very important,Extremely important,Extremely important,Extremely important,Extremely important,is it morally right to study the participant without their consent?,7.0,3.0,6.0,4.0,1.0,5.0,2.0,None,1.0,,,,
336,True,528.0,Facebook,28.0,Male,White / Caucasian,Bachelor's degree,Slightly liberal,Extremely aware,"['… are large and can contain millions of data points', '… are naturalistic in that they do not require researchers to directly interact with research volunteers', '… often capture social relationships not found using traditional methods (e.g. surveys)', '… are readily accessible to researchers and easy to collect']",['None of the above'],"['Political elections (e.g. voting behavior)', 'Economic forecasting', 'Presidential approval ratings', 'Health topics (e.g. spread of diseases)', 'Well-being and economic satisfaction', 'Communication (e.g. spread of opinions and hate-speech)', 'Public sentiment (e.g. environment-related concerns)', 'News consumption (e.g. sharing of misinformation)', 'Social networks']",2,0,9,Morally correct.,Completely acceptable,,,Completely acceptable,,,Somewhat acceptable,,,Somewhat acceptable,,,Moderately important,Extremely important,Moderately important,Very important,Slightly important,Slightly important,Moderately important,Slightly important,Moderately important,,6.0,4.0,2.0,3.0,1.0,7.0,5.0,,,,,,
337,True,728.0,Facebook,64.0,Male,White / Caucasian,Highschool,Slightly conservative,Very aware,"['… are large and can contain millions of data points', '… reflect events in real-time and can be collected continuously over time', '… often capture social relationships not found using traditional methods (e.g. surveys)', '… are readily accessible to researchers and easy to collect']","['Creating fake accounts (""bots"")', 'Secretly changing the content of what users see']","['Political elections (e.g. voting behavior)', 'Economic forecasting', 'Presidential approval ratings', 'Health topics (e.g. spread of diseases)', 'Well-being and economic satisfaction', 'Communication (e.g. spread of opinions and hate-speech)', 'Public sentiment (e.g. environment-related concerns)', 'News consumption (e.g. sharing of misinformation)', 'Social networks']",2,0,9,"There is (or should be ) oversight from someone in charge, and who is ethical.",Somewhat acceptable,,,Somewhat unacceptable,,,Neutral,,,Somewhat unacceptable,,,Very important,Extremely important,Very important,Very important,Extremely important,Very important,Moderately important,Very important,Very important,,1.0,4.0,2.0,5.0,7.0,3.0,6.0,,,,,,
338,True,1056.0,Twitter,36.0,Male,White / Caucasian,Highschool,Slightly liberal,Moderately aware,"['… are large and can contain millions of data points', '… reflect events in real-time and can be collected continuously over time', '… are naturalistic in that they do not require researchers to directly interact with research volunteers', '… often capture social relationships not found using traditional methods (e.g. surveys)', '… are readily accessible to researchers and easy to collect']","['Privately messaging users', ""Publicly posting on users' profiles"", 'Creating fake accounts (""bots"")', 'Secretly changing the content of what users see']","['Political elections (e.g. voting behavior)', 'Economic forecasting', 'Presidential approval ratings', 'Health topics (e.g. spread of diseases)', 'Well-being and economic satisfaction', 'Communication (e.g. spread of opinions and hate-speech)', 'Public sentiment (e.g. environment-related concerns)', 'News consumption (e.g. sharing of misinformation)', 'Social networks']",3,2,9,"Proof that the experiment is not done against people's wills and if people ask, all data will be deleted.",Completely acceptable,i think reducing hate in the world is a worth while goal,,Completely acceptable,,,Somewhat unacceptable,seeing the feed of other people not in the study is pretty unacceptable,"i don't know how you would go about collecting the data without seeing other people's feeds, but there has to be some way",Somewhat acceptable,,,Very important,Slightly important,Very important,Not at all important,Moderately important,Not at all important,Slightly important,Not at all important,Very important,,7.0,4.0,3.0,1.0,2.0,6.0,5.0,,8.0,,9.0,,10.0
339,True,1113.0,Reddit,39.0,Male,White / Caucasian,Associate's degree,Very liberal,Slightly aware,"['… are large and can contain millions of data points', '… reflect events in real-time and can be collected continuously over time', '… are naturalistic in that they do not require researchers to directly interact with research volunteers', '… often capture social relationships not found using traditional methods (e.g. surveys)', '… are readily accessible to researchers and easy to collect']",['None of the above'],"['Political elections (e.g. voting behavior)', 'Economic forecasting', 'Presidential approval ratings', 'Health topics (e.g. spread of diseases)', 'Well-being and economic satisfaction', 'Communication (e.g. spread of opinions and hate-speech)', 'Public sentiment (e.g. environment-related concerns)', 'News consumption (e.g. sharing of misinformation)']",3,0,8,Ethical approval from the institution means they will act in a way that responsible and takes in to account the persons they are researching. ,Somewhat acceptable,if the posts were empathetic i can see how this would be ok and not ethically ambiguous,,Somewhat unacceptable,participants should be aware they are part of a study it may be hard to get good data this way but seems slightly unethical,,Completely acceptable,this seems to be all laid out for the participants and is known to them so it seems very ethical,,Somewhat unacceptable,the participants should be made aware that they are in the study,"they could ask for the participant to take part in the study, submit their twitter account before using a bot to tweet them",Extremely important,Extremely important,Very important,Moderately important,Very important,Very important,Very important,Very important,Moderately important,"when publicly tweeting someone who is not aware they are part of a study, that would change what they tweet or how they tweet if they became aware of it eventually",6.0,3.0,4.0,2.0,1.0,5.0,7.0,,,,,,
340,True,1075.0,Facebook,37.0,Male,White / Caucasian,Master's degree or above,Very liberal,Moderately aware,"['… are large and can contain millions of data points', '… reflect events in real-time and can be collected continuously over time', '… are naturalistic in that they do not require researchers to directly interact with research volunteers', '… often capture social relationships not found using traditional methods (e.g. surveys)', '… are readily accessible to researchers and easy to collect', '… are always representative of people’s offline behavior']","['Privately messaging users', ""Publicly posting on users' profiles"", 'Creating fake accounts (""bots"")']","['Political elections (e.g. voting behavior)', 'Health topics (e.g. spread of diseases)', 'Well-being and economic satisfaction', 'Communication (e.g. spread of opinions and hate-speech)', 'Public sentiment (e.g. environment-related concerns)', 'News consumption (e.g. sharing of misinformation)', 'Social networks']",2,3,7,It means receiving approval from an IRB or other institution that has oversight over study approval. They make sure the studies to not hamr their subjects.,Completely acceptable,,,Completely acceptable,,,Completely acceptable,,,Completely acceptable,,,Moderately important,Not at all important,Moderately important,Not at all important,Not at all important,Very important,Very important,Moderately important,Moderately important,,6.0,7.0,4.0,1.0,5.0,3.0,2.0,,,,,,
341,True,1198.0,Facebook,64.0,Female,White / Caucasian,Bachelor's degree,Very liberal,Moderately aware,"['… are large and can contain millions of data points', '… often capture social relationships not found using traditional methods (e.g. surveys)', '… are readily accessible to researchers and easy to collect']",['Privately messaging users'],"['Political elections (e.g. voting behavior)', 'Presidential approval ratings', 'Communication (e.g. spread of opinions and hate-speech)']",1,1,3,Ethical approval means getting clearance to obtain data from a research subject.,Somewhat unacceptable,i think it was unethical to create anonymous accounts and include people in their study without their knowledge,creating accounts and commenting on subjects’ posts is unethical,Somewhat unacceptable,,,Somewhat unacceptable,it is unethical to pay people to influence the amount of likes a page gets,,Somewhat unacceptable,it is not acceptable to create accounts just to interact with someone’s post,,Very important,Extremely important,Very important,Very important,Very important,Very important,Extremely important,Extremely important,Very important,,6.0,2.0,4.0,1.0,3.0,7.0,5.0,,,,,,
342,True,551.0,Twitter,36.0,Male,White / Caucasian,Highschool,Slightly liberal,Not at all aware,"['… are large and can contain millions of data points', '… reflect events in real-time and can be collected continuously over time', '… are naturalistic in that they do not require researchers to directly interact with research volunteers', '… often capture social relationships not found using traditional methods (e.g. surveys)', '… are readily accessible to researchers and easy to collect']",['None of the above'],"['Political elections (e.g. voting behavior)', 'Economic forecasting', 'Presidential approval ratings', 'Health topics (e.g. spread of diseases)', 'Well-being and economic satisfaction', 'Communication (e.g. spread of opinions and hate-speech)', 'Public sentiment (e.g. environment-related concerns)', 'News consumption (e.g. sharing of misinformation)', 'Social networks']",3,0,9,"It means that, in the opinion of the institution, the study and its methods are morally acceptable.",Somewhat acceptable,,,Somewhat acceptable,i think the same should have been done for left-leaning websites,,Somewhat acceptable,,,Somewhat acceptable,,,Moderately important,Moderately important,Very important,Moderately important,Moderately important,Moderately important,Very important,Moderately important,Moderately important,,7.0,2.0,1.0,5.0,3.0,6.0,4.0,,,,,,
343,True,636.0,Facebook,33.0,Female,White / Caucasian,Highschool,Slightly liberal,Slightly aware,"['… are large and can contain millions of data points', '… reflect events in real-time and can be collected continuously over time', '… are naturalistic in that they do not require researchers to directly interact with research volunteers', '… often capture social relationships not found using traditional methods (e.g. surveys)', '… are readily accessible to researchers and easy to collect', '… are well formatted and never contain any missing data']",['None of the above'],"['Presidential approval ratings', 'Health topics (e.g. spread of diseases)', 'Well-being and economic satisfaction', 'News consumption (e.g. sharing of misinformation)', 'Social networks']",2,0,5,to make sure they are not doing anything that is immoral or wrong ,Somewhat acceptable,"although they did not know they were part of a study, the benefits were good",,Somewhat acceptable,i do not think any harm was done,,Completely acceptable,this was done 100% correctly and everyone involved knew what was happening,,Somewhat acceptable,,,Moderately important,Slightly important,Extremely important,Slightly important,Slightly important,Slightly important,Slightly important,Extremely important,Moderately important,,7.0,6.0,5.0,4.0,1.0,3.0,2.0,,,,,,
344,True,682.0,Twitter,55.0,Male,White / Caucasian,Master's degree or above,Slightly liberal,Slightly aware,"['… are large and can contain millions of data points', '… reflect events in real-time and can be collected continuously over time', '… are naturalistic in that they do not require researchers to directly interact with research volunteers', '… are readily accessible to researchers and easy to collect']","[""Publicly posting on users' profiles"", 'Creating fake accounts (""bots"")', 'Secretly changing the content of what users see']","['Political elections (e.g. voting behavior)', 'Health topics (e.g. spread of diseases)', 'Well-being and economic satisfaction', 'Communication (e.g. spread of opinions and hate-speech)', 'Public sentiment (e.g. environment-related concerns)', 'News consumption (e.g. sharing of misinformation)', 'Social networks']",2,1,7,It means some entity or individual reviews the study procedures and determines them to be ethical -- it is unlikely to harm someone and the benefits of the research outweigh the risks.,Somewhat acceptable,the people in the study didn't consent to participate but the overall effect was a net positive,,Somewhat acceptable,they did not know they were part of a study which is less than ideal,,Completely acceptable,,,Somewhat unacceptable,it sounds like it made their behavior more toxic which isn't great,,Moderately important,Not at all important,Moderately important,Slightly important,Not at all important,Slightly important,Very important,Moderately important,Slightly important,"if the information being collected is more private such as sexual behavior, substance use",7.0,5.0,4.0,1.0,6.0,2.0,3.0,,,,,,
345,True,374.0,Twitter,26.0,Male,White / Caucasian,Bachelor's degree,Slightly liberal,Very aware,"['… are large and can contain millions of data points', '… reflect events in real-time and can be collected continuously over time', '… are naturalistic in that they do not require researchers to directly interact with research volunteers', '… are unaffected by the way social media platforms work']","[""Publicly posting on users' profiles"", 'Creating fake accounts (""bots"")', 'Secretly changing the content of what users see']","['Political elections (e.g. voting behavior)', 'Economic forecasting', 'Presidential approval ratings', 'Health topics (e.g. spread of diseases)', 'Well-being and economic satisfaction', 'Communication (e.g. spread of opinions and hate-speech)', 'Public sentiment (e.g. environment-related concerns)', 'News consumption (e.g. sharing of misinformation)', 'Social networks']",2,1,9,"Ensuring that no harm comes to the participants in the surveys, either psychological or physical.",Completely unacceptable,,,Somewhat unacceptable,,,Completely acceptable,,,Somewhat acceptable,,,Moderately important,Very important,Moderately important,Very important,Moderately important,Very important,Very important,Extremely important,Very important,giving consent and providing debriefing procedures,7.0,4.0,6.0,5.0,1.0,3.0,2.0,,,,,,
346,True,414.0,Twitter,29.0,Male,Hispanic,Bachelor's degree,Slightly liberal,Slightly aware,"['… are large and can contain millions of data points', '… reflect events in real-time and can be collected continuously over time', '… are naturalistic in that they do not require researchers to directly interact with research volunteers', '… often capture social relationships not found using traditional methods (e.g. surveys)', '… are readily accessible to researchers and easy to collect']","['Creating fake accounts (""bots"")']","['Political elections (e.g. voting behavior)', 'Economic forecasting', 'Presidential approval ratings', 'Health topics (e.g. spread of diseases)', 'Well-being and economic satisfaction', 'Communication (e.g. spread of opinions and hate-speech)', 'Public sentiment (e.g. environment-related concerns)', 'News consumption (e.g. sharing of misinformation)', 'Social networks']",3,1,9,I think it means that the researchers can prove that the experiment will not cause anyone harm.,Completely acceptable,,,Somewhat acceptable,i think it is unethical to not let people know they are part of a study,,Completely acceptable,,,Somewhat acceptable,i still think it is unethical to not let people know they are part of an academic study,,Slightly important,Not at all important,Slightly important,Not at all important,Not at all important,Moderately important,Extremely important,Slightly important,Slightly important,no i think that covered them all,7.0,1.0,5.0,6.0,2.0,4.0,3.0,,,,,,
347,True,1164.0,Facebook,53.0,Female,White / Caucasian,Vocational training,Neutral/ Neither conservative or liberal,Extremely aware,"['… reflect events in real-time and can be collected continuously over time', '… are readily accessible to researchers and easy to collect']","['Privately messaging users', ""Publicly posting on users' profiles"", 'Creating fake accounts (""bots"")', 'Secretly changing the content of what users see']","['Economic forecasting', 'Communication (e.g. spread of opinions and hate-speech)', 'Public sentiment (e.g. environment-related concerns)', 'News consumption (e.g. sharing of misinformation)', 'Social networks']",0,2,5,"Ethical approval means that there are certain protocol that academic researchers must abide by, like following the laws and rules on media platforms without violating the rights of the people. ",Completely unacceptable,users should have been aware of the studyi seriously doubt that a person that writes hate speech would delete it just because someone else sounded empathetic,,Completely unacceptable,that's why when i get erroneous messages i tend to block the user and i highly doubt that someone would share higher quality news after having been sent the private message participants should have been made aware,,Completely acceptable,,,Completely unacceptable,the participants should have been made aware that they were part of a study,that's why i block certain users if i see some funnyunusual stuff going on,Extremely important,Extremely important,Extremely important,Extremely important,Extremely important,Extremely important,Extremely important,Extremely important,Extremely important,"awareness by the user, extremely important",7.0,1.0,3.0,5.0,6.0,4.0,2.0,,,,,,
348,True,811.0,Facebook,37.0,Male,Mixed race,Highschool,Neutral/ Neither conservative or liberal,Extremely aware,['… are readily accessible to researchers and easy to collect'],"['Privately messaging users', ""Publicly posting on users' profiles""]","['Political elections (e.g. voting behavior)', 'Economic forecasting', 'Presidential approval ratings', 'Health topics (e.g. spread of diseases)', 'Well-being and economic satisfaction', 'Communication (e.g. spread of opinions and hate-speech)', 'Public sentiment (e.g. environment-related concerns)', 'News consumption (e.g. sharing of misinformation)', 'Social networks']",-1,2,9,By contacting the social networks and getting their approval with users concent. ,Completely acceptable,,,Completely acceptable,,,Completely acceptable,,,Completely acceptable,,,Extremely important,Extremely important,Extremely important,Extremely important,Extremely important,Extremely important,Extremely important,Extremely important,Extremely important,all the responses were raw and that's how the most accurate data is collected,5.0,4.0,6.0,3.0,2.0,7.0,1.0,,,,,,
349,True,741.0,Twitter,43.0,Male,White / Caucasian,Highschool,Very liberal,Very aware,"['… are large and can contain millions of data points', '… reflect events in real-time and can be collected continuously over time', '… are naturalistic in that they do not require researchers to directly interact with research volunteers', '… are readily accessible to researchers and easy to collect']","['Privately messaging users', ""Publicly posting on users' profiles""]","['Political elections (e.g. voting behavior)', 'Economic forecasting', 'Presidential approval ratings', 'Health topics (e.g. spread of diseases)', 'Well-being and economic satisfaction', 'Communication (e.g. spread of opinions and hate-speech)', 'Public sentiment (e.g. environment-related concerns)', 'News consumption (e.g. sharing of misinformation)', 'Social networks']",2,2,9,The way they go about getting their data needs to be approved by a board to ensure researchers comply with a code of ethics. ,Somewhat unacceptable,the participants did not give informed consent to be in the study,if the participants willingly consented i would find this study acceptable,Somewhat unacceptable,the participants did not give their informed consent,the study would be more acceptable if participants gave consent,Completely acceptable,,,Somewhat unacceptable,the participants did not give informed consent for the study,it would be acceptable if participants knew and accepted that they were in a study,Not at all important,Not at all important,Slightly important,Slightly important,Not at all important,Not at all important,Extremely important,Slightly important,Not at all important,,5.0,1.0,4.0,3.0,2.0,7.0,6.0,,0.0,,0.0,,0.0
350,True,2680.0,Reddit,26.0,Male,White / Caucasian,Bachelor's degree,Slightly conservative,Very aware,"['… are large and can contain millions of data points', '… reflect events in real-time and can be collected continuously over time', '… often capture social relationships not found using traditional methods (e.g. surveys)', '… are readily accessible to researchers and easy to collect']","[""Publicly posting on users' profiles"", 'Creating fake accounts (""bots"")']","['Political elections (e.g. voting behavior)', 'Presidential approval ratings', 'Well-being and economic satisfaction', 'Communication (e.g. spread of opinions and hate-speech)', 'Public sentiment (e.g. environment-related concerns)', 'News consumption (e.g. sharing of misinformation)']",2,2,6,To ensure that whatever tactics they use over social media to collect data is not invading privacy ,Somewhat acceptable,"no concerns, i don’t think this is unethical",,Somewhat unacceptable,slightly unethical to not alert participants they are part of a research study,,Completely unacceptable,"i find it very unacceptable to bribe people,to install a browser extension, i think this is wrong and an invasion of privacy",,Somewhat acceptable,i am surprised this increased toxicity,,Slightly important,Slightly important,Slightly important,Moderately important,Slightly important,Moderately important,Slightly important,Very important,Moderately important,"engagement in the study just like this survey, are they participants paying attention",7.0,4.0,5.0,2.0,1.0,6.0,3.0,,,,,,
351,True,1079.0,Reddit,24.0,Male,White / Caucasian,Bachelor's degree,Prefer not to say,Very aware,"['… are large and can contain millions of data points', '… reflect events in real-time and can be collected continuously over time', '… are readily accessible to researchers and easy to collect']",['None of the above'],"['Communication (e.g. spread of opinions and hate-speech)', 'Public sentiment (e.g. environment-related concerns)', 'News consumption (e.g. sharing of misinformation)', 'Social networks']",1,0,4,Ethical approval means the purpose of the study should not go against any moral rules or law and should not hurt anyone's feeling.,Neutral,,,Neutral,,,Neutral,,,Neutral,,,Very important,Very important,Very important,Very important,Very important,Very important,Very important,Very important,Very important,,5.0,1.0,7.0,4.0,3.0,6.0,2.0,,,,,,
352,True,2838.0,Twitter,27.0,Female,White / Caucasian,Associate's degree,Slightly liberal,Slightly aware,"['… are large and can contain millions of data points', '… reflect events in real-time and can be collected continuously over time', '… are naturalistic in that they do not require researchers to directly interact with research volunteers', '… often capture social relationships not found using traditional methods (e.g. surveys)', '… are readily accessible to researchers and easy to collect']","['Creating fake accounts (""bots"")']","['Presidential approval ratings', 'Well-being and economic satisfaction', 'Communication (e.g. spread of opinions and hate-speech)', 'Public sentiment (e.g. environment-related concerns)', 'News consumption (e.g. sharing of misinformation)', 'Social networks']",3,1,6,"I think ethical approval means that research experiments have to meet certain requirements in order to ensure the participants rights, privacy, and welfare are being respected.",Completely acceptable,i liked the idea of this study that increasing empathetic awareness can possibly reduce hate speech,"if the researchers published the names of the user accounts that contained hate speech without their knowledge and consent, then that would violate their rights and be unethical",Somewhat acceptable,i think it would have been more ethical if the researchers had simply commented on the public post rather than send an unsolicited private message,i would find it ethically unacceptable if the researchers publicly shared the results of their findings without the consent of the twitter users unless they kept the identities anonymous,Somewhat acceptable,i like that participants were given the opportunity to choose whether they would want to participate in the research study,i find that the compensation for the study was slightly unethical because participants had to download a browser and have their data collected for 8 weeks for only a $5 guarantee,Somewhat unacceptable,i find it interesting that it decreased users' quality and increased their language toxicity,"i find it slightly unethical that they used automated, human-looking accounts instead of creating accounts run by humans because it decreased the trust of the twitter participants",Moderately important,Extremely important,Moderately important,Very important,Very important,Very important,Very important,Very important,Slightly important,there are no other aspects that i can think of,7.0,6.0,5.0,2.0,1.0,4.0,3.0,if participants were not aware of their participation in the initial study they should be made aware after and be allowed to choose whether or not the data collected about them can be used or discarded,8.0,,,,
353,True,422.0,Facebook,46.0,Male,White / Caucasian,Bachelor's degree,Slightly liberal,Very aware,['… are large and can contain millions of data points'],"['Creating fake accounts (""bots"")', 'Secretly changing the content of what users see']","['Political elections (e.g. voting behavior)', 'Economic forecasting', 'Presidential approval ratings', 'Health topics (e.g. spread of diseases)', 'Well-being and economic satisfaction', 'Communication (e.g. spread of opinions and hate-speech)', 'Public sentiment (e.g. environment-related concerns)', 'News consumption (e.g. sharing of misinformation)', 'Social networks']",1,0,9,The research method doesn't cross any perceived ethical boundaries.,Completely acceptable,,,Completely acceptable,,,Completely acceptable,,,Completely acceptable,,,Slightly important,Not at all important,Slightly important,Very important,Not at all important,Moderately important,Moderately important,Slightly important,Extremely important,,1.0,6.0,7.0,4.0,3.0,2.0,5.0,,,,,,
354,True,948.0,Facebook,52.0,Female,White / Caucasian,Highschool,Slightly conservative,Very aware,"['… are large and can contain millions of data points', '… reflect events in real-time and can be collected continuously over time', '… are naturalistic in that they do not require researchers to directly interact with research volunteers', '… often capture social relationships not found using traditional methods (e.g. surveys)', '… are readily accessible to researchers and easy to collect']","[""Publicly posting on users' profiles"", 'Creating fake accounts (""bots"")']","['Political elections (e.g. voting behavior)', 'Economic forecasting', 'Presidential approval ratings', 'Health topics (e.g. spread of diseases)', 'Well-being and economic satisfaction', 'Communication (e.g. spread of opinions and hate-speech)', 'Public sentiment (e.g. environment-related concerns)', 'News consumption (e.g. sharing of misinformation)', 'Social networks']",3,2,9,Make sure the study is ethical and doesn't use any personally identifying info,Neutral,trying to sway public opinion in this way is a slippery slope,,Somewhat unacceptable,they should not have private messaged the users,,Completely acceptable,,,Somewhat acceptable,,,Slightly important,Not at all important,Moderately important,Not at all important,Slightly important,Extremely important,Very important,Slightly important,Slightly important,,7.0,3.0,5.0,2.0,1.0,6.0,4.0,,,,,,
355,True,1211.0,Facebook,47.0,Male,White / Caucasian,Bachelor's degree,Neutral/ Neither conservative or liberal,Moderately aware,"['… are large and can contain millions of data points', '… reflect events in real-time and can be collected continuously over time', '… are naturalistic in that they do not require researchers to directly interact with research volunteers', '… are readily accessible to researchers and easy to collect']","[""Publicly posting on users' profiles"", 'Creating fake accounts (""bots"")']","['Health topics (e.g. spread of diseases)', 'Communication (e.g. spread of opinions and hate-speech)', 'News consumption (e.g. sharing of misinformation)', 'Social networks']",2,2,4,"Ethical behavior for an institution would involve or pertain to them
not doing anything that would discredit or embarass the institution,
as well as not breaking any laws while they are acting on behalf of 
the institution.",Completely acceptable,i think that people have the right to say what ever they want to  if these researchers were able to conduct a study that reduced hate speechi completely support it,"creating or pretending to be someone you are not on the internet is a verygray area  however, it is a known fact that this happens all the time  on datingsites, pornography sites, chat rooms, meta verse, etc",Somewhat acceptable,"sending someone a private message does give me concern, that the recipient might have confused the sender for someone they know  however, the resultswere interesting to say the least",,Completely unacceptable,"bribery to sway someone's oppinion is not very ethical  worse the research study has no value, because the results of the data was tainted or biased",,Somewhat acceptable,challenging someone's beliefs is totally acceptable  i am not surprised thatpeople did not change their mind  potentially making the situation worse,,Moderately important,Extremely important,Moderately important,Very important,Very important,Moderately important,Extremely important,Moderately important,Moderately important,this type of research is only going to give you data on a small demographic  as longas the researchers know this,6.0,7.0,3.0,5.0,1.0,4.0,2.0,None,7.0,None,8.0,,9.0
356,True,1672.0,Reddit,28.0,Male,African-American,Highschool,Slightly liberal,Moderately aware,"['… are large and can contain millions of data points', '… are naturalistic in that they do not require researchers to directly interact with research volunteers']",['Secretly changing the content of what users see'],"['Political elections (e.g. voting behavior)', 'Economic forecasting', 'Presidential approval ratings', 'Health topics (e.g. spread of diseases)', 'Well-being and economic satisfaction', 'Communication (e.g. spread of opinions and hate-speech)', 'Public sentiment (e.g. environment-related concerns)', 'News consumption (e.g. sharing of misinformation)', 'Social networks']",2,-1,9,Getting ethical approval involves clearance from a institution to ensure that the research will be conducted honestly and morally.,Somewhat acceptable,my concern with this study is that the participants were not aware a research study was being conducted,,Somewhat acceptable,my concern with this study is that the participants were not aware of the research study being conducted,,Somewhat acceptable,,,Neutral,my concern with this study is that the participants involved weren't aware of the research study,the use of automated accounts that look real influenced how ethically acceptable i find this research,Slightly important,Not at all important,Slightly important,Slightly important,Slightly important,Slightly important,Very important,Slightly important,Slightly important,i cannot think of any other aspects of research conducted on social media that are important to me in determining levels of concern,7.0,2.0,5.0,3.0,1.0,6.0,4.0,,,,,,
357,True,1096.0,Facebook,62.0,Male,White / Caucasian,Bachelor's degree,Slightly conservative,Not at all aware,"['… are large and can contain millions of data points', '… reflect events in real-time and can be collected continuously over time', '… are naturalistic in that they do not require researchers to directly interact with research volunteers', '… often capture social relationships not found using traditional methods (e.g. surveys)']",['Privately messaging users'],"['Political elections (e.g. voting behavior)', 'Economic forecasting', 'Presidential approval ratings', 'Health topics (e.g. spread of diseases)', 'Well-being and economic satisfaction', 'Public sentiment (e.g. environment-related concerns)', 'News consumption (e.g. sharing of misinformation)']",4,1,7,That the researcher will uphold to the ethical guidelines that are outlined by the university they represent. The research they are going to run is ethically sound and will not violate any ethical policies.,Somewhat unacceptable,creating fake accounts on twitter to hide behind is not ethical and makes people not want to trust twitter this is a form of trying to change peoples behaviors and thinking through the use of bots,,Somewhat unacceptable,participants should be informed they are part of a research project upfront the use of bots to automate their process i disagree with,,Completely acceptable,this is more acceptable because participants are informed ahead of time about the use of their data,,Somewhat unacceptable,i don't agree with them hiding behind bots to complete their research and not telling the end user this was for research purposes upfront,,Slightly important,Extremely important,Very important,Slightly important,Extremely important,Extremely important,Extremely important,Very important,Slightly important,,6.0,1.0,7.0,3.0,2.0,5.0,4.0,,,,,,
358,True,1613.0,Twitter,64.0,Female,White / Caucasian,Bachelor's degree,Slightly conservative,Moderately aware,['… are readily accessible to researchers and easy to collect'],['None of the above'],['None of the above'],-1,0,0,"Ethical approval to me means that the study is performed according to a set of standards that maintains the quality of the work . It meets standards that deem it to be well thought out, honest and correct to form a view.",Completely unacceptable,"again, not letting the twitter user that their data is being used does not seem honest and above boardi even have a hard time with the ethics of the researchers on prolific when they state, ""we're sorry, but we had to deceive you"", it reeks of manipulation that i will never understand is needed i am sure it is ""for the greater good"", but it still feels dishonest and not trustworthy",,Completely unacceptable,"not ethical at all to me i totally find this is not ethical to have users information collected in this way especially being a responder on prolific and seeing all of the verbiage that we have to read and agree to and learning about the things that researchers have to do to maintain a good pool of respondents, this does not make sense at all to me",,Somewhat acceptable,"this type of information gathering requires the twitter user to agree to their data being used, so it is not unlike any other online study, so this is okay with me as far as ethics by users agreeing to their data being used, my thought is it probably rules out all of the bots that are so prevalent on twitter",,Completely unacceptable,"the idea that one is not informed that their replies are being used is not acceptable to me, because information in many twitter accounts can successfully identify the person i use twitter a lot, only for sports but i do see a lot of different topics, many political that are posted the amount of bots on twitter is astounding to me, and i would never consider using it for data processing just my opinion",,Moderately important,Extremely important,Not at all important,Extremely important,Extremely important,Extremely important,Extremely important,Extremely important,Extremely important,,7.0,1.0,3.0,2.0,4.0,6.0,5.0,,,,,,
359,True,1096.0,Facebook,69.0,Female,White / Caucasian,Highschool,Slightly liberal,Not at all aware,"['… are large and can contain millions of data points', '… reflect events in real-time and can be collected continuously over time', '… are naturalistic in that they do not require researchers to directly interact with research volunteers', '… often capture social relationships not found using traditional methods (e.g. surveys)', '… are readily accessible to researchers and easy to collect']",['None of the above'],"['Political elections (e.g. voting behavior)', 'Health topics (e.g. spread of diseases)', 'Communication (e.g. spread of opinions and hate-speech)', 'Public sentiment (e.g. environment-related concerns)', 'News consumption (e.g. sharing of misinformation)']",3,0,5,They must adhere to the accepted standards of the institution.,Completely unacceptable,,,Completely unacceptable,i really do not like tricks or deception on any level,,Completely acceptable,the study was completely transparent,,Neutral,"i'm not a big fan of participants being unaware, but as long as they remained anonymous i'm neutral on this one",,Very important,Not at all important,Slightly important,Very important,Extremely important,Very important,Extremely important,Slightly important,Very important,,7.0,1.0,6.0,2.0,4.0,5.0,3.0,,,,,,
360,True,698.0,Twitter,33.0,Male,White / Caucasian,Highschool,Very liberal,Very aware,"['… are large and can contain millions of data points', '… are naturalistic in that they do not require researchers to directly interact with research volunteers', '… are readily accessible to researchers and easy to collect']","['Privately messaging users', ""Publicly posting on users' profiles""]","['Political elections (e.g. voting behavior)', 'Communication (e.g. spread of opinions and hate-speech)', 'Public sentiment (e.g. environment-related concerns)', 'News consumption (e.g. sharing of misinformation)']",1,2,4,A board that oversees the study and ensures it meets all the requirements to be considered ethical and a minimal risk to the participants. ,Somewhat acceptable,,,Somewhat acceptable,,,Completely acceptable,,,Somewhat acceptable,,,Extremely important,Extremely important,Very important,Moderately important,Very important,Moderately important,Extremely important,Very important,Moderately important,,6.0,3.0,4.0,2.0,1.0,7.0,5.0,,,,,,
361,True,2749.0,Facebook,70.0,Male,White / Caucasian,Bachelor's degree,Slightly conservative,Slightly aware,"['… are large and can contain millions of data points', '… reflect events in real-time and can be collected continuously over time', '… often capture social relationships not found using traditional methods (e.g. surveys)']","['Privately messaging users', ""Publicly posting on users' profiles"", 'Creating fake accounts (""bots"")', 'Secretly changing the content of what users see']","['Political elections (e.g. voting behavior)', 'Presidential approval ratings', 'Health topics (e.g. spread of diseases)', 'Well-being and economic satisfaction', 'Communication (e.g. spread of opinions and hate-speech)', 'Public sentiment (e.g. environment-related concerns)', 'News consumption (e.g. sharing of misinformation)']",3,2,7,Using honest and transparent methods that do not involve the spread of misleading information or the manipulation of users' opinions and beliefs.,Somewhat unacceptable,"once again, users were not informed that they were part of a studysecondly, based on my experience from reading hate speech, i seriously doubt that a majority of people deleted their ""hate"" post after reading an empathetic response from a researcher the posts that i most often see deleted are those where someone has posted a reply that shows that the original poster misinterpreted some facts and were provided with correct info the rest of them often enjoy their roles as trolls and do not bother deleting much of anything",,Somewhat unacceptable,"the users were not aware that they were part of the study and very importantly, the study was limited to conservative users only i find that objectionable and wide open for manipulating data and drawing misleading conclusions","the researchers should have also tested liberalprogressive users who posted links to liberal websites that were also allegedly ""untrustworthy""",Somewhat acceptable,"most importantly, the researchers got the approval of their users first at least the users were aware that they were taking part in a study even though, in my mind, they were severely underpaid",,Completely unacceptable,"i object to most studies in which users are not informed that they are being studied and that they are being manipulatedsecondly, i would like to see the type of reply that was originally sent this study almost directly contradicts the results reached in the last study in which people deleted their hate speech because they got a link to a fact checking site along with an empathetic responselastly, i now do my own fact checking after learning that quite a few of these fact checkers are deliberately manipulating and distorting info because of their own bias i simply no longer trust the ""fact checkers""",,Slightly important,Very important,Very important,Slightly important,Extremely important,Extremely important,Extremely important,Extremely important,Very important,"once again my focus, based on my experience on social media along with my interest in doing studiessurveys on prolific, is that users be informed if there is an intent to try to change or manipulate someone's online behaviorstudying posts objectively is one thing, but deliberately trying to get someone to act differently is unacceptable that is what advertisers, political operatives and propagandists do it is may also be why i have seen user activity drop off during this current campaign season too many accounts are being flagged for supposed violations when people have only posted honest questions regarding the facts or truth behind some claim",1.0,2.0,3.0,4.0,5.0,7.0,6.0,"all steps should be taken to avoid one-sided bias that will taint the final results for example, asking broad questions regarding opinions on ""immigration"" without drilling down and asking the same questions about ""illegal immigration""",3.0,,,,
362,True,1393.0,Facebook,29.0,Male,White / Caucasian,Highschool,Very liberal,Extremely aware,"['… reflect events in real-time and can be collected continuously over time', '… are naturalistic in that they do not require researchers to directly interact with research volunteers', '… often capture social relationships not found using traditional methods (e.g. surveys)', '… are readily accessible to researchers and easy to collect', '… are always representative of people’s offline behavior']","['Privately messaging users', ""Publicly posting on users' profiles"", 'Creating fake accounts (""bots"")']","['Political elections (e.g. voting behavior)', 'Economic forecasting', 'Presidential approval ratings', 'Health topics (e.g. spread of diseases)', 'Well-being and economic satisfaction', 'Communication (e.g. spread of opinions and hate-speech)', 'Public sentiment (e.g. environment-related concerns)', 'News consumption (e.g. sharing of misinformation)', 'Social networks']",1,3,9,Make sure it's not going to harm or endanger anyone or make their findings public. Just some basic guidelines on how now to be a dick while doing your research,Somewhat acceptable,,,Somewhat unacceptable,they probably should have been told at some point that it was a research study,,Somewhat acceptable,,,Neutral,,,Moderately important,Slightly important,Extremely important,Slightly important,Moderately important,Moderately important,Very important,Moderately important,Moderately important,,5.0,1.0,4.0,3.0,2.0,7.0,6.0,,,,,,
363,True,1609.0,Facebook,41.0,Female,White / Caucasian,Bachelor's degree,Very liberal,Moderately aware,"['… are large and can contain millions of data points', '… reflect events in real-time and can be collected continuously over time', '… are naturalistic in that they do not require researchers to directly interact with research volunteers', '… often capture social relationships not found using traditional methods (e.g. surveys)', '… are readily accessible to researchers and easy to collect']","['Creating fake accounts (""bots"")']","['Political elections (e.g. voting behavior)', 'Presidential approval ratings', 'Well-being and economic satisfaction', 'Communication (e.g. spread of opinions and hate-speech)', 'Public sentiment (e.g. environment-related concerns)', 'News consumption (e.g. sharing of misinformation)', 'Social networks']",3,1,7,I believe this would mean that the institution must approve of the study and make sure that it is not breaking any ethical boundaries set forth by the institution.,Somewhat acceptable,"although i do not feel like this is a huge ethical issue, i do feel that any type of misleading intentionally might sit on an ethical borderline","the fact that the fake accounts were used to try and suppress hate speech, makes it more ethical in my opinion",Somewhat unacceptable,i feel like because the twitter users were intentionally mislead and the fact that it was a private message makes it less ethical,"if this was something done strictly on a public platform, i would find it more acceptable",Completely acceptable,"i feel that since all the participants were informed of the process and offered compensation and they willingly participated, there are not any unethical practices used in the process",i would find it unethical if the researchers mislead the participants or if they used the browser extension to gather information that the participants were not informed of,Completely acceptable,"since this was done in a public setting, i feel like it is more ethically acceptable than the other study that was similar, but done through private messages",,Very important,Moderately important,Slightly important,Moderately important,Slightly important,Very important,Extremely important,Slightly important,Very important,i feel like anything intentionally misleading is ethically questionable,4.0,6.0,7.0,1.0,3.0,5.0,2.0,participants should not be intentionally mislead,4.0,,,,
364,True,939.0,Twitter,26.0,Male,White / Caucasian,Bachelor's degree,Very liberal,Moderately aware,"['… are large and can contain millions of data points', '… reflect events in real-time and can be collected continuously over time', '… are naturalistic in that they do not require researchers to directly interact with research volunteers', '… often capture social relationships not found using traditional methods (e.g. surveys)', '… are readily accessible to researchers and easy to collect']","['Privately messaging users', ""Publicly posting on users' profiles"", 'Creating fake accounts (""bots"")', 'Secretly changing the content of what users see', ""Hacking into users' accounts""]","['Political elections (e.g. voting behavior)', 'Economic forecasting', 'Presidential approval ratings', 'Health topics (e.g. spread of diseases)', 'Well-being and economic satisfaction', 'Communication (e.g. spread of opinions and hate-speech)', 'Public sentiment (e.g. environment-related concerns)', 'News consumption (e.g. sharing of misinformation)', 'Social networks']",3,1,9,"Ethical approval means that a proposed experiment has been giving the green light to move forward based on a standardized set of 'ethical' principles (usually things like maintaining anonymity of participants, limited health risks, etc.)",Somewhat unacceptable,using people's data without consent for a study seems unethical,"if users gave their consent before their data was published, this would be totally acceptable",Completely acceptable,,"if the users' accounts were made public, that would affect my opinion",Neutral,"my only concern is that the browser extension allowed researches to see all of the users' posts i think this would be okay if it was explicitly consented to by the participants, though the above doesn't specify",,Somewhat unacceptable,"i personally have no issue with this study, though objectively it seems a little dubious to study individuals without their knowledge like this","if the participants gave their consent for their data to be used at the end of the study, that would be more ethical",Extremely important,Not at all important,Moderately important,Moderately important,Not at all important,Slightly important,Extremely important,Slightly important,Very important,,3.0,4.0,7.0,2.0,1.0,5.0,6.0,,,,,,
365,True,1041.0,Twitter,36.0,Male,White / Caucasian,Master's degree or above,Neutral/ Neither conservative or liberal,Moderately aware,"['… are large and can contain millions of data points', '… reflect events in real-time and can be collected continuously over time', '… are naturalistic in that they do not require researchers to directly interact with research volunteers', '… often capture social relationships not found using traditional methods (e.g. surveys)', '… are readily accessible to researchers and easy to collect']","['Privately messaging users', 'Creating fake accounts (""bots"")']","['Political elections (e.g. voting behavior)', 'Economic forecasting', 'Presidential approval ratings', 'Health topics (e.g. spread of diseases)', 'Well-being and economic satisfaction', 'Communication (e.g. spread of opinions and hate-speech)', 'Public sentiment (e.g. environment-related concerns)', 'News consumption (e.g. sharing of misinformation)', 'Social networks']",3,2,9,"I assume it means that, since actual people are being ""studied,"" that there needs to be a review of the study protocol to make sure that the methods used are ethical.",Completely acceptable,"same as before, this is all public and anyone can do these things, so i have no issue with it",,Completely acceptable,"again, these researchers are just observing public activity everything they did was allowable by anyone, so i have no issues with this",,Completely acceptable,,,Completely acceptable,"this is all public, so i have no issue with the researchers observing this",,Not at all important,Not at all important,Not at all important,Not at all important,Not at all important,Slightly important,Slightly important,Not at all important,Not at all important,if it involves anything beyond mere interaction on social media and observation of public posts,7.0,3.0,6.0,2.0,4.0,5.0,1.0,,,,,,
366,True,1124.0,Twitter,27.0,Male,White / Caucasian,Associate's degree,Neutral/ Neither conservative or liberal,Very aware,"['… are large and can contain millions of data points', '… reflect events in real-time and can be collected continuously over time', '… often capture social relationships not found using traditional methods (e.g. surveys)', '… are readily accessible to researchers and easy to collect']","['Privately messaging users', ""Publicly posting on users' profiles""]","['Well-being and economic satisfaction', 'Communication (e.g. spread of opinions and hate-speech)', 'Public sentiment (e.g. environment-related concerns)', 'News consumption (e.g. sharing of misinformation)']",2,2,4,The researcher/researchers will abide by ethical standards. ,Neutral,in order for the study's results to be accurate users couldn't know that the researchers were running a study,,Neutral,"in order to get accurate results for the study, the users couldn't know that they were being surveyed",telling the users about the study after it was completed would have made it a bit more ethical,Completely acceptable,the researchers gave users an option whether they wanted to be a part of the study or not,if the researchers just tracked the people that signed up for the study without asking them first,Somewhat acceptable,,if at the end they let the users know about the study,Moderately important,Not at all important,Extremely important,Moderately important,Slightly important,Moderately important,Not at all important,Extremely important,Not at all important,whether or not the research is going to be publicly available,3.0,6.0,5.0,1.0,2.0,7.0,4.0,,,,,,
367,True,1049.0,Twitter,41.0,Female,African-American,Bachelor's degree,Very liberal,Moderately aware,"['… are large and can contain millions of data points', '… reflect events in real-time and can be collected continuously over time', '… are naturalistic in that they do not require researchers to directly interact with research volunteers', '… often capture social relationships not found using traditional methods (e.g. surveys)', '… are always representative of people’s offline behavior']",['Secretly changing the content of what users see'],"['Political elections (e.g. voting behavior)', 'Economic forecasting', 'Health topics (e.g. spread of diseases)', 'Well-being and economic satisfaction', 'Communication (e.g. spread of opinions and hate-speech)', 'Public sentiment (e.g. environment-related concerns)', 'News consumption (e.g. sharing of misinformation)']",3,-1,7,Its like a ethical standard that needs to be adhered to during research.,Completely acceptable,i feel its quit acceptable posting something that reduces the hate in general also since it helps one to rethink their post,,Somewhat acceptable,,,Somewhat acceptable,,,Neutral,,,Very important,Moderately important,Extremely important,Very important,Moderately important,Very important,Very important,Very important,Moderately important,,6.0,5.0,7.0,1.0,2.0,3.0,4.0,"participants should be informed if they want their data to be shared,",5.0,,9.0,,10.0
368,True,722.0,Facebook,36.0,Female,White / Caucasian,Bachelor's degree,Neutral/ Neither conservative or liberal,Not at all aware,"['… are large and can contain millions of data points', '… reflect events in real-time and can be collected continuously over time', '… are naturalistic in that they do not require researchers to directly interact with research volunteers', '… often capture social relationships not found using traditional methods (e.g. surveys)', '… are readily accessible to researchers and easy to collect']","['Privately messaging users', ""Publicly posting on users' profiles"", 'Creating fake accounts (""bots"")']","['Political elections (e.g. voting behavior)', 'Presidential approval ratings', 'Communication (e.g. spread of opinions and hate-speech)', 'Public sentiment (e.g. environment-related concerns)', 'News consumption (e.g. sharing of misinformation)', 'Social networks']",3,3,6,That ensures researchers are not doing any data collection without users being aware of their data potentially being collected.,Completely acceptable,"even though users were not informed about being in this research, it ultimately was for a good cause and helpful in making progress towards less hate speech on social media",,Completely acceptable,,,Completely acceptable,,,Neutral,"i feel like this is acceptable because when you sign up for social media, if you are posting something publicly it is assumed that anyone can look at these posts and reply to them",,Moderately important,Moderately important,Extremely important,Not at all important,Moderately important,Slightly important,Moderately important,Very important,Extremely important,,6.0,4.0,7.0,2.0,1.0,5.0,3.0,,,,,,
369,True,915.0,Facebook,39.0,Male,Mixed race,Bachelor's degree,Slightly liberal,Slightly aware,"['… reflect events in real-time and can be collected continuously over time', '… are readily accessible to researchers and easy to collect']","['Privately messaging users', ""Publicly posting on users' profiles"", 'Creating fake accounts (""bots"")']","['Political elections (e.g. voting behavior)', 'Economic forecasting', 'Presidential approval ratings', 'Health topics (e.g. spread of diseases)', 'Well-being and economic satisfaction', 'Communication (e.g. spread of opinions and hate-speech)', 'Public sentiment (e.g. environment-related concerns)', 'News consumption (e.g. sharing of misinformation)', 'Social networks']",0,3,9,I would guess that the institution that the researcher is doing the research work on behalf of has some standard of ethics that must be followed.  So in order to conduct the research or publish it they would need to obtain ethical approval. ,Somewhat acceptable,,,Neutral,,,Completely unacceptable,"this is clearly trying to skew how people view certain topics in social media  if thousands of people are not ""liking"" posts organically it makes post engagement fake  especially if this was something that was more related to fake news, and they receive 30k likes, that is problematic",,Neutral,"i have found that some ""fact-checking"" sites end up having wrong information as well  a great case is how the idea that masks don't work spread  many studies have been conducted and some very reputable scientific organizations have studies on their websites that say masks do not work, but the data is typically very small or the type of mask used was a very thin cloth mask, but it gives fuel to people who spread the false information that masking does not work",,Very important,Moderately important,Moderately important,Moderately important,Moderately important,Moderately important,Moderately important,Slightly important,Moderately important,,4.0,2.0,5.0,1.0,7.0,6.0,3.0,,,,,,
370,True,898.0,Facebook,27.0,Female,White / Caucasian,Highschool,Slightly liberal,Slightly aware,"['… reflect events in real-time and can be collected continuously over time', '… are naturalistic in that they do not require researchers to directly interact with research volunteers', '… often capture social relationships not found using traditional methods (e.g. surveys)', '… are readily accessible to researchers and easy to collect']",['None of the above'],"['Communication (e.g. spread of opinions and hate-speech)', 'Public sentiment (e.g. environment-related concerns)', 'News consumption (e.g. sharing of misinformation)', 'Social networks']",2,0,4,"I'm not really sure, but considering the context and definition of the words individually, my best guess is it is confirmation that the researchers are being ethical in their studies",Somewhat acceptable,,,Completely acceptable,,,Completely acceptable,,,Somewhat unacceptable,,,Moderately important,Moderately important,Moderately important,Very important,Very important,Moderately important,Moderately important,Moderately important,Very important,,7.0,5.0,6.0,3.0,1.0,2.0,4.0,,,,,,
371,True,1072.0,Reddit,55.0,Female,White / Caucasian,Associate's degree,Slightly conservative,Not at all aware,['… reflect events in real-time and can be collected continuously over time'],"['Creating fake accounts (""bots"")']","['Political elections (e.g. voting behavior)', 'Presidential approval ratings', 'Communication (e.g. spread of opinions and hate-speech)', 'Public sentiment (e.g. environment-related concerns)', 'News consumption (e.g. sharing of misinformation)', 'Social networks']",1,1,6,is it ethical to lie to people?,Completely acceptable,,,Completely acceptable,,,Completely acceptable,,,Somewhat acceptable,,,Very important,Extremely important,Moderately important,Very important,Extremely important,Very important,Moderately important,Very important,Very important,,3.0,7.0,6.0,2.0,1.0,4.0,5.0,,,,,,
372,True,1515.0,Facebook,68.0,Female,White / Caucasian,Bachelor's degree,Slightly liberal,Moderately aware,"['… are large and can contain millions of data points', '… reflect events in real-time and can be collected continuously over time', '… are naturalistic in that they do not require researchers to directly interact with research volunteers', '… often capture social relationships not found using traditional methods (e.g. surveys)', '… are readily accessible to researchers and easy to collect']","[""Publicly posting on users' profiles"", 'Creating fake accounts (""bots"")']","['Political elections (e.g. voting behavior)', 'Presidential approval ratings', 'Health topics (e.g. spread of diseases)', 'Well-being and economic satisfaction', 'Communication (e.g. spread of opinions and hate-speech)', 'Public sentiment (e.g. environment-related concerns)', 'News consumption (e.g. sharing of misinformation)', 'Social networks']",3,2,8,ethical approval means that the research has been reviewed by an ethics board to insure that it does not violate standard and protocols of the research. this would mean that the research has value and the participant's rights are protected.,Neutral,"my main concern remains that individuals were not giving informed consent but, with the understanding that the posts are in the public domain - not just shared to friends - perhaps that is not really an ethical issue?  i'm a bit torn here","the results are illuminating in so far as it goes, but i would like to know how long lasting the effect of the empathetic messages were just the 4 days, longer, permanent change?",Neutral,participants were uninformed the idea of private messaging someone is also bothersome to me,i understand the need to not inform participants and i suppose since all information gathered was in a public shared space there is no presumption of privacy,Completely acceptable,participants self selected and were informed the option to continue to participate in the research was at their discretion i find no ethical concerns with this methodi am curious about how the researchers determined that the original political views were unchanged even in the face of more exposure to opposing news sources especially since the participants were voluntarily visiting the sites with more frequency and had less negative views about them,,Neutral,"wow, just goes to show that social media feeds on itself a public message is determined immediately to be hostile - both to the original poster and their followers who maintain similar opinions i have seen this play out on facebook where the language gets so violent and inappropriate, i have snoozed people this happened rather frequently with covid responses and supporters of t's big lie",,Slightly important,Extremely important,Very important,Moderately important,Slightly important,Moderately important,Moderately important,Not at all important,Very important,,7.0,6.0,5.0,3.0,1.0,4.0,2.0,,,,,,
373,True,447.0,Facebook,38.0,Male,White / Caucasian,Master's degree or above,Very conservative,Very aware,"['… are large and can contain millions of data points', '… reflect events in real-time and can be collected continuously over time', '… are naturalistic in that they do not require researchers to directly interact with research volunteers', '… are always representative of people’s offline behavior']","[""Publicly posting on users' profiles"", 'Creating fake accounts (""bots"")', ""Hacking into users' accounts""]","['Political elections (e.g. voting behavior)', 'Presidential approval ratings', 'Health topics (e.g. spread of diseases)', 'Communication (e.g. spread of opinions and hate-speech)', 'Public sentiment (e.g. environment-related concerns)', 'News consumption (e.g. sharing of misinformation)', 'Social networks']",2,1,7,"In my opinion, ethical approval is ensure you are not deceiving anyone when asking or gather information. You are being upfront and receiving users approval. ",Completely unacceptable,"again, i feel the users should be informed on the situation and what is occurring",,Completely unacceptable,"i understand that when posting on social media, you content is at the will of everyone but, i feel if researcher or analytics are going to be performed against your inputs, you should be notified","they aren't deceiving the users, they just aren't keeping them informed",Somewhat acceptable,i see no real ethical issue with this statement that is shown above,,Completely unacceptable,"i think any time you are purposely deceiving people and not informing them about what the true reasoningoutliner is, there is an ethical dilemma",,Very important,Very important,Very important,Extremely important,Moderately important,Moderately important,Extremely important,Extremely important,Extremely important,,2.0,6.0,3.0,1.0,4.0,7.0,5.0,,,,,,
374,True,1399.0,Twitter,55.0,Male,White / Caucasian,Bachelor's degree,Very conservative,Slightly aware,['None of the above'],"['Creating fake accounts (""bots"")']","['Political elections (e.g. voting behavior)', 'Economic forecasting', 'Presidential approval ratings', 'Health topics (e.g. spread of diseases)', 'Well-being and economic satisfaction', 'Communication (e.g. spread of opinions and hate-speech)', 'Public sentiment (e.g. environment-related concerns)', 'News consumption (e.g. sharing of misinformation)', 'Social networks']",0,1,9,It means a reviewer would ensure the research would not require illegal or unethical procedures.,Completely unacceptable,no informed consent troll farms and the people that pay them should be illegal,,Completely unacceptable,"using bots on unaware citizens without their consent would seem to be unethical not to mention the famous case of the linkedin founder funding the troll farm ""research"" to manipulate the alabama special election unethical if not criminal",,Somewhat unacceptable,,,Completely unacceptable,"no informed consent and complete manipulation of citizens via bots these sound like the studies are actually being conducted so unethical people can learn how to manipulate people online in real time these should be considered actual ""misinformation campaigns""",,Slightly important,Slightly important,Slightly important,Not at all important,Slightly important,Slightly important,Not at all important,Slightly important,Not at all important,"informed consent fake accountsbots, especially in the middle of an election, are a psyop manipulation funded by the opposing powers",7.0,1.0,6.0,4.0,3.0,5.0,2.0,"true ""academic"" research would not accept money from political parties",1.0,,,,
375,True,1062.0,Facebook,64.0,Male,White / Caucasian,Bachelor's degree,Slightly conservative,Very aware,"['… are large and can contain millions of data points', '… are readily accessible to researchers and easy to collect']",['None of the above'],"['Political elections (e.g. voting behavior)', 'Economic forecasting', 'Presidential approval ratings', 'Health topics (e.g. spread of diseases)', 'Well-being and economic satisfaction', 'Communication (e.g. spread of opinions and hate-speech)', 'Public sentiment (e.g. environment-related concerns)', 'News consumption (e.g. sharing of misinformation)', 'Social networks']",0,0,9,Make sure that research is done  honest and doesn't offend anybody,Somewhat unacceptable,"i don't like when these researches are done ""secretly""",,Somewhat unacceptable,it looks like it is targeted too much to one side of the political spectrum,,Completely acceptable,,,Somewhat acceptable,,,Very important,Not at all important,Moderately important,Not at all important,Slightly important,Not at all important,Extremely important,Very important,Very important,,7.0,2.0,5.0,3.0,1.0,6.0,4.0,,,,,,
376,True,1853.0,Facebook,58.0,Female,White / Caucasian,Bachelor's degree,Very conservative,Moderately aware,"['… are large and can contain millions of data points', '… reflect events in real-time and can be collected continuously over time', '… are readily accessible to researchers and easy to collect']","['Privately messaging users', ""Publicly posting on users' profiles"", 'Creating fake accounts (""bots"")', 'Secretly changing the content of what users see']","['Political elections (e.g. voting behavior)', 'Economic forecasting', 'Presidential approval ratings', 'Health topics (e.g. spread of diseases)', 'Well-being and economic satisfaction', 'Communication (e.g. spread of opinions and hate-speech)', 'Public sentiment (e.g. environment-related concerns)', 'News consumption (e.g. sharing of misinformation)', 'Social networks']",1,2,9,They have to show that the participants wouldn't be deceived or abused in any way.,Completely acceptable,the anonymity of twitter already draws an inordinate amount of these kinds of posters,,Somewhat acceptable,"it starts from the common misconception that right-leaning will share ""misinformation"" it's biased and starts with creating misinformation -- which leads to a self-fulfilling prophecy",if i found out who labeled the misinformation(same people who labeled hunter's laptop?) and if i found out that left leaning were also studied,Somewhat unacceptable,i have a serious issue with tracking people and it started with a group that wanted to be track - which is a different animal than the norm,,Neutral,"why all the interest in censorship? rumors and lies have been spread for as long as humans can communicate only in the last 5 years have we been saddled with partisan ""fact-checkers"" who care nothing about facts with the amount of fact-checking failures, especially in the last ~3 years, any research based on this will prove pointless russia russia, laptops,https:wwwtheblazecomnewsivermectin-covid-treatment-new-study?utm_source=theblaze-7daytrendingtest&utm_medium=email&utm_campaign=the%20blaze%20pm%20trending%202022-09-03&utm_term=active%20list%20-%207%20day%20engagement etc",,Very important,Not at all important,Not at all important,Not at all important,Slightly important,Slightly important,Moderately important,Not at all important,Moderately important,"social media, simply does not represent society extrapolating based on the opinions of thousands of responses from accounts that might not even be real, from general narcissists with too much time on their hands isn't really scientific it's just lazy tbh",2.0,7.0,4.0,3.0,1.0,6.0,5.0,,,,,,
377,True,2179.0,Facebook,61.0,Male,White / Caucasian,Bachelor's degree,Slightly conservative,Not at all aware,"['… are large and can contain millions of data points', '… are readily accessible to researchers and easy to collect']","[""Publicly posting on users' profiles"", 'Creating fake accounts (""bots"")']","['Political elections (e.g. voting behavior)', 'Health topics (e.g. spread of diseases)', 'Public sentiment (e.g. environment-related concerns)']",0,2,3,Approval by the university or organization for the procedures used to conduct the study.,Completely acceptable,,,Completely acceptable,,,Completely acceptable,,,Somewhat acceptable,,,Moderately important,Not at all important,Slightly important,Not at all important,Not at all important,Moderately important,Very important,Slightly important,Moderately important,,2.0,6.0,4.0,7.0,1.0,3.0,5.0,,,,,,
378,True,500.0,Facebook,59.0,Female,White / Caucasian,Master's degree or above,Very conservative,Slightly aware,"['… are large and can contain millions of data points', '… reflect events in real-time and can be collected continuously over time', '… are naturalistic in that they do not require researchers to directly interact with research volunteers', '… often capture social relationships not found using traditional methods (e.g. surveys)', '… are readily accessible to researchers and easy to collect']","['Privately messaging users', ""Publicly posting on users' profiles"", 'Creating fake accounts (""bots"")', 'Secretly changing the content of what users see']","['Political elections (e.g. voting behavior)', 'Economic forecasting', 'Presidential approval ratings', 'Health topics (e.g. spread of diseases)', 'Well-being and economic satisfaction', 'Communication (e.g. spread of opinions and hate-speech)', 'Public sentiment (e.g. environment-related concerns)', 'News consumption (e.g. sharing of misinformation)', 'Social networks']",3,2,9,"I would think ethical would involve honesty, full disclosure, gaining permission from those being studied, and giving no harm to those the information is gathered from. ",Completely unacceptable,"basically, the researchers lied that is unacceptable to me period","no, no more information is needed the researchers lied, period",Completely unacceptable,"again, there is deception here so it's wrong",,Completely acceptable,researchers were up front and honest and people got to pick their reward,,Completely unacceptable,"same, the researchers created fake accounts that looked like people this is fraudulent",,Slightly important,Not at all important,Not at all important,Not at all important,Not at all important,Slightly important,Extremely important,Not at all important,Slightly important,,7.0,3.0,4.0,6.0,2.0,5.0,1.0,,8.0,,9.0,,10.0
379,True,1194.0,Facebook,54.0,Female,White / Caucasian,Highschool,Neutral/ Neither conservative or liberal,Moderately aware,['… reflect events in real-time and can be collected continuously over time'],"['Creating fake accounts (""bots"")', 'Secretly changing the content of what users see']","['Political elections (e.g. voting behavior)', 'Communication (e.g. spread of opinions and hate-speech)', 'News consumption (e.g. sharing of misinformation)', 'Social networks']",1,0,4,the researcher is showing that they have lived up to the accepted ethical standards. We have the right to know who has access to their data and what is being done with it.,Neutral,,,Somewhat unacceptable,,,Somewhat acceptable,,,Somewhat acceptable,,,Very important,Moderately important,Very important,Moderately important,Moderately important,Moderately important,Very important,Moderately important,Moderately important,,3.0,2.0,5.0,1.0,6.0,7.0,4.0,,,,,,
380,True,373.0,Twitter,26.0,Female,White / Caucasian,Bachelor's degree,Very liberal,Very aware,"['… are large and can contain millions of data points', '… reflect events in real-time and can be collected continuously over time']","['Creating fake accounts (""bots"")']","['Political elections (e.g. voting behavior)', 'Economic forecasting', 'Presidential approval ratings', 'Health topics (e.g. spread of diseases)', 'Well-being and economic satisfaction', 'Communication (e.g. spread of opinions and hate-speech)', 'Public sentiment (e.g. environment-related concerns)', 'News consumption (e.g. sharing of misinformation)', 'Social networks']",2,1,9,"sign off on the fact that waht theyre doing is morally right
",Somewhat acceptable,None,,Completely acceptable,,,Completely acceptable,ethical because peple were completely aware that it was an experiment,,Completely acceptable,,,Moderately important,Slightly important,Moderately important,Slightly important,Slightly important,Slightly important,Very important,Moderately important,Very important,,7.0,6.0,4.0,3.0,1.0,5.0,2.0,,,,,,
381,True,726.0,Reddit,29.0,Male,White / Caucasian,Bachelor's degree,Very liberal,Moderately aware,['… reflect events in real-time and can be collected continuously over time'],['Secretly changing the content of what users see'],['Well-being and economic satisfaction'],1,-1,1,approving ethical ways' of running the studies,Somewhat acceptable,seems a little underhanded but it got the results they wanted in the end,,Completely acceptable,its about time someone deals the the loons of the right,,Somewhat acceptable,,,Somewhat unacceptable,,,Very important,Very important,Extremely important,Very important,Slightly important,Moderately important,Moderately important,Moderately important,Very important,,4.0,6.0,2.0,1.0,3.0,5.0,7.0,,,,,,
382,True,1738.0,Facebook,38.0,Female,African-American,Highschool,Slightly liberal,Not at all aware,"['… are large and can contain millions of data points', '… reflect events in real-time and can be collected continuously over time', '… often capture social relationships not found using traditional methods (e.g. surveys)', '… are readily accessible to researchers and easy to collect']","[""Publicly posting on users' profiles"", 'Creating fake accounts (""bots"")']","['Political elections (e.g. voting behavior)', 'Well-being and economic satisfaction', 'Communication (e.g. spread of opinions and hate-speech)', 'Public sentiment (e.g. environment-related concerns)', 'Social networks']",2,2,5,"a review of the experiment made by people in charge to see if  they  don t violated  people privacy ,decency  or laws  , how s appropriate it is ",Somewhat acceptable,i think they should have been aware they were in the study and seek for an approval of consent before conducting the study,people in the study  should have been aware or  notified people before going forward with the study,Neutral,privacy concerned being monitored online for people views,you need people consent to  do a study on them,Completely acceptable,,,Somewhat unacceptable,identifying based on their views raised privacy concern and conducting a study without people consent  raised ethical  concern,if people were notified first and consent to be part of the study,Moderately important,Very important,Moderately important,Very important,Slightly important,Moderately important,Extremely important,Moderately important,Moderately important,,7.0,2.0,5.0,4.0,1.0,6.0,3.0,,8.0,,,,
383,True,869.0,Twitter,40.0,Female,White / Caucasian,Bachelor's degree,Very liberal,Extremely aware,"['… are large and can contain millions of data points', '… reflect events in real-time and can be collected continuously over time', '… are naturalistic in that they do not require researchers to directly interact with research volunteers', '… often capture social relationships not found using traditional methods (e.g. surveys)', '… are readily accessible to researchers and easy to collect']","['Privately messaging users', ""Publicly posting on users' profiles"", 'Creating fake accounts (""bots"")', 'Secretly changing the content of what users see']","['Political elections (e.g. voting behavior)', 'Economic forecasting', 'Presidential approval ratings', 'Health topics (e.g. spread of diseases)', 'Well-being and economic satisfaction', 'Communication (e.g. spread of opinions and hate-speech)', 'Public sentiment (e.g. environment-related concerns)', 'News consumption (e.g. sharing of misinformation)', 'Social networks']",3,2,9,"Ethical in this case probably means that the researchers can not collect personally identifying information from users they collect data from, they can't hack into user's accounts, they can not contact the people or try to get information from them that may skew their research. ",Somewhat unacceptable,i question the ethics of researchers contacting and commenting on social profiles for research without informing the users they are part of a research project,,Completely unacceptable,i don't think it's acceptable for researchers to directly message user's with unsolicited messages,,Somewhat acceptable,i think this is fine except all users should have been offered to see the results and that the money options could have been a separate incentive,,Somewhat unacceptable,i think it's an interesting way to get to a point but i question the ethics of interacting with social media users for research under false pretenses,,Very important,Very important,Moderately important,Slightly important,Very important,Extremely important,Extremely important,Extremely important,Very important,,6.0,1.0,4.0,2.0,5.0,7.0,3.0,,0.0,,0.0,,0.0
384,True,1365.0,Reddit,30.0,Female,White / Caucasian,Bachelor's degree,Very liberal,Moderately aware,"['… reflect events in real-time and can be collected continuously over time', '… are naturalistic in that they do not require researchers to directly interact with research volunteers', '… are readily accessible to researchers and easy to collect']","['Privately messaging users', 'Creating fake accounts (""bots"")']","['Political elections (e.g. voting behavior)', 'Economic forecasting', 'Presidential approval ratings', 'Health topics (e.g. spread of diseases)', 'Communication (e.g. spread of opinions and hate-speech)', 'Public sentiment (e.g. environment-related concerns)', 'News consumption (e.g. sharing of misinformation)', 'Social networks']",1,2,8,I think ethical approval means that the researcher submits the methods they plan to use to an ethics board to make sure it is safe and ethical.,Somewhat acceptable,"again, i think using publicly available tweets is very ethical i'm unsure about the content of the researcher's created twitter replies, so i would want to be sure that they aren't being hateful or harmful before i could be sure this is completely acceptable",i would want to know the various content of the messages created by the researchers,Neutral,i think directly engaging the user in a private message might involve too much direct interaction that would require disclosure that this is part of a study,i'd like to know the exact messages they are sending,Neutral,by running a targeted ad you don't really get a random enough sample i do think that being transparent about this being part of a study and getting approval to use the extension is important,i would just want to be sure that participants are well informed about the data collection process,Completely acceptable,i don't think there was any harm done here and all data collected was from public tweets,,Very important,Not at all important,Slightly important,Not at all important,Moderately important,Very important,Very important,Moderately important,Extremely important,"if there's going to be interaction from the researchers, its important to make sure that the messaging is not harmful or unethical",7.0,4.0,5.0,2.0,1.0,6.0,3.0,,,,,,
385,True,754.0,Facebook,33.0,Female,White / Caucasian,Master's degree or above,Neutral/ Neither conservative or liberal,Not at all aware,"['… are large and can contain millions of data points', '… reflect events in real-time and can be collected continuously over time', '… are naturalistic in that they do not require researchers to directly interact with research volunteers', '… are readily accessible to researchers and easy to collect']","['Privately messaging users', 'Creating fake accounts (""bots"")']","['Political elections (e.g. voting behavior)', 'Economic forecasting', 'Presidential approval ratings', 'Health topics (e.g. spread of diseases)', 'Well-being and economic satisfaction', 'Communication (e.g. spread of opinions and hate-speech)', 'Public sentiment (e.g. environment-related concerns)', 'News consumption (e.g. sharing of misinformation)', 'Social networks']",2,2,9,"It means that gathering the data wouldn't pose any harm to the individuals whose posts are being looked at and included in the data. It also wouldn't use any personally identifiable information so that when the research is released, no one would be able to identify an individual who was included in it.",Somewhat acceptable,i feel like this is more acceptable since it had a positive impact on society by helping decrease the amount of hate speech that gets posted online,i would like to know more about what the replies actually said,Somewhat acceptable,i don't see any harm here so i'd say it was mostly acceptable,,Completely acceptable,"the participants were informed that they were part of a research study, so the researcher was completely covered",,Neutral,"i don't like that the created accounts were automated as they lost out on some of the emotional connection i think comes from having a human behind-the-scenes, but i also don't see the individual being harmed it's unfortunate that the partisan slant and language toxicity increased",i would like to see what the automated reply said,Moderately important,Slightly important,Slightly important,Not at all important,Moderately important,Moderately important,Moderately important,Slightly important,Moderately important,the way in which the repliesmessages are written,7.0,5.0,6.0,2.0,1.0,4.0,3.0,,,,,,
386,True,1232.0,Reddit,60.0,Male,White / Caucasian,Master's degree or above,Slightly conservative,Very aware,"['… are large and can contain millions of data points', '… reflect events in real-time and can be collected continuously over time', '… are naturalistic in that they do not require researchers to directly interact with research volunteers', '… often capture social relationships not found using traditional methods (e.g. surveys)', '… are readily accessible to researchers and easy to collect']","['Privately messaging users', ""Publicly posting on users' profiles""]","['Political elections (e.g. voting behavior)', 'Economic forecasting', 'Presidential approval ratings', 'Health topics (e.g. spread of diseases)', 'Well-being and economic satisfaction', 'Communication (e.g. spread of opinions and hate-speech)', 'Public sentiment (e.g. environment-related concerns)', 'News consumption (e.g. sharing of misinformation)', 'Social networks']",3,2,9,Presumably they have some version of an institutional review board that they present the basic outline of their study and its methods to.  Using well-established guidelines the board would then either approve or disapprove the study and often importantly funding for the study.,Completely acceptable,"as ever i would have concerns about funding potentially leading to bias also i suppose there's a huge definitional issue about what constitutes hate speech, so i would worry that the people targeted might've been subjectively chosen which could skew the data",,Somewhat acceptable,my only slight concern is the private messaging and frankly i don't know why that's causing me more concerned or than maybe it seems generated by human rather than the automated messaging involved it seems more personal at this point,of course there is always the concern about funding and bias i wonder if because of the private messaging whether there was any supplemental back-and-forth between the unwilling participant and someone behind the study which has potential for some form of abuse or corruption of data,Completely acceptable,just funding and potential bias,i think the level of compensation was woefully low which could potentially have skewed the results based on who would possibly participate for such a small amount of money or some lottery chance(i notice that the word acceptable is misspelled in the completely acceptable option),Completely acceptable,my only concern is that the study monitored the results for only the 24 hours after i would think he would want to monitor for at least a week after the public reply,"always concerned about what entity is funding the study, potential for bias",Moderately important,Extremely important,Extremely important,Slightly important,Slightly important,Very important,Slightly important,Not at all important,Extremely important,just what entity funded the research and whether an irb or its equivalent was overseeing the research,6.0,7.0,4.0,3.0,1.0,5.0,2.0,transparency of what entity is actually funding the research and whether there is bias,3.0,,,,
387,True,763.0,Twitter,50.0,Male,Asian - Eastern,Bachelor's degree,Slightly conservative,Very aware,"['… are large and can contain millions of data points', '… reflect events in real-time and can be collected continuously over time', '… are readily accessible to researchers and easy to collect']","[""Publicly posting on users' profiles"", 'Creating fake accounts (""bots"")']","['Political elections (e.g. voting behavior)', 'Economic forecasting', 'Well-being and economic satisfaction', 'Communication (e.g. spread of opinions and hate-speech)', 'Public sentiment (e.g. environment-related concerns)', 'News consumption (e.g. sharing of misinformation)', 'Social networks']",1,2,7,Review research for violations of academic ethical principles,Somewhat unacceptable,,,Neutral,i think the study should not only send links to right-leaning accounts,,Completely acceptable,,,Somewhat acceptable,,,Very important,Slightly important,Slightly important,Slightly important,Slightly important,Moderately important,Very important,Moderately important,Slightly important,None,3.0,5.0,2.0,1.0,7.0,6.0,4.0,,,,,,
388,True,1546.0,Reddit,34.0,Female,African-American,Master's degree or above,Very liberal,Not at all aware,"['… are large and can contain millions of data points', '… reflect events in real-time and can be collected continuously over time', '… are naturalistic in that they do not require researchers to directly interact with research volunteers', '… often capture social relationships not found using traditional methods (e.g. surveys)', '… are readily accessible to researchers and easy to collect']","['Privately messaging users', ""Publicly posting on users' profiles"", 'Creating fake accounts (""bots"")', 'Secretly changing the content of what users see', ""Hacking into users' accounts""]","['Political elections (e.g. voting behavior)', 'Economic forecasting', 'Presidential approval ratings', 'Health topics (e.g. spread of diseases)', 'Well-being and economic satisfaction', 'Communication (e.g. spread of opinions and hate-speech)', 'Public sentiment (e.g. environment-related concerns)']",3,1,7,"Ethical approval probably relates to getting approval to participate in studies from users that seems upfront and fair, but is probably not fully alerting participants to what is used in the study",Completely acceptable,,"no one is getting harmed or misinformed here the study is actually trying to help people, so i think it's acceptable even though they did not know they were in a study",Somewhat unacceptable,it's not ethical to not tell people that they are part of a research study,the part about not telling people that they are part of a research study because misinformation is spread too much and now the participants will likely believe things that are untrue,Completely acceptable,,"everyone was informed, so i think this is a good study",Somewhat unacceptable,concern is that they are influencing people in important decisions with no human bots,"i don't think it's acceptable because non human bots were used and even though they linked to a fact checking website, they are still influencing people and that will cause more divisiveness",Very important,Slightly important,Very important,Not at all important,Slightly important,Very important,Extremely important,Extremely important,Extremely important,,7.0,2.0,5.0,4.0,1.0,3.0,6.0,,,,,,
389,True,1347.0,Facebook,31.0,Male,White / Caucasian,Bachelor's degree,Slightly conservative,Moderately aware,"['… are large and can contain millions of data points', '… reflect events in real-time and can be collected continuously over time', '… are readily accessible to researchers and easy to collect']","['Privately messaging users', 'Creating fake accounts (""bots"")']","['Economic forecasting', 'Health topics (e.g. spread of diseases)', 'Communication (e.g. spread of opinions and hate-speech)', 'Public sentiment (e.g. environment-related concerns)', 'Social networks']",1,2,5,"I think that ethical approval means that the experiments will be conducted in such a way that no party is harmed in any way, shape, or fashion. No negatives will come to either party for the way that these experiments are conducted.",Neutral,"while i'm not in favor of using what individuals post on social media as a study tool without their consent, it does seem that this study wasn't done to single anyone out rather, this was more of a behavioral study to see how the poster's actions may change after receiving an empathetic reply of sorts for this reason i am neutral in feeling to this study that was conducted",i would love to see the message that was posted by the researches to what was posted in order to see what was said and how it was worded,Somewhat unacceptable,i'm not a supporter of researchers creating fake accounts and messaging potential test subjects in order to try and collect information,"i feel that the individuals who were messaged by the researches should be informed of why they are being contacted, and that information that they provide will be used in an academic study if this is done, then fair play, but it seems that was not done here",Somewhat acceptable,i feel that this study was fair because the researchers seemed to be transparent about the information that they would be collecting,,Somewhat unacceptable,"again, i'm not in favor of researchers creating any sort of fake account in order to communicate with possible test subjects or what they are posting this seems like an invasion of privacy, and seems to undermine the legitimacy of social media",,Very important,Very important,Moderately important,Very important,Very important,Moderately important,Very important,Moderately important,Very important,"i would like to take into account the reputation of the researchers, or the institution in which they are conducting their research from if the reputation is of high regard, then i would likely be more lenient towards the researchers and trust that they are carrying out their research in good faith and with good practice",7.0,1.0,4.0,2.0,6.0,5.0,3.0,"i would find it advisable that the subjects not be provoked in any way, shape, or form simply conduct activities based on what the subject has freely said publicly",5.0,,,,
390,True,948.0,Reddit,40.0,Male,White / Caucasian,Bachelor's degree,Very conservative,Moderately aware,"['… are large and can contain millions of data points', '… reflect events in real-time and can be collected continuously over time', '… are readily accessible to researchers and easy to collect', '… are always representative of people’s offline behavior']","['Creating fake accounts (""bots"")', 'Secretly changing the content of what users see']","['Political elections (e.g. voting behavior)', 'Economic forecasting', 'Presidential approval ratings', 'Well-being and economic satisfaction', 'Public sentiment (e.g. environment-related concerns)', 'Social networks']",0,0,6,I believe it just means to do research in an ethical way that isn't biased and gains the approval while respecting the privacy of the researcher and it's participants.,Completely unacceptable,i agree with the method and i think it's positive however the one thing that i don't like is that the people posting hate speeches we're guinea pigs to an experiment without their consent,i know that i certainly wouldn't like to be part of an experiment without me person consenting to it,Somewhat acceptable,again my only concern is that people are part of an experiment without their consent but it's good that there is now higher quality news constant among all the fake news,this one is more ethical than the other one,Completely acceptable,i can actually agree to this one because the users were actually told it they wanted to opt into the research study then they were given a choice if they wanted to download something invasive or not,so many ways for people to get manipulated with these studies i agree with this one being one of the good ones,Completely unacceptable,and i'm never for someone to be part of a research set they don't know about because it's very deceptive even though i get that it would be more genuine if you would like this but it is unethical,fake news is a plague but there's got to be better ways to get rid of it deception,Moderately important,Moderately important,Very important,Extremely important,Extremely important,Moderately important,Extremely important,Very important,Moderately important,the only one that comes to mind to me is privacy and consent i would hate to be a part of the study that i did not consent to order results of,7.0,1.0,4.0,2.0,5.0,6.0,3.0,,,,,,
391,True,604.0,Reddit,24.0,Male,White / Caucasian,Highschool,Very liberal,Extremely aware,"['… are large and can contain millions of data points', '… reflect events in real-time and can be collected continuously over time', '… are naturalistic in that they do not require researchers to directly interact with research volunteers', '… often capture social relationships not found using traditional methods (e.g. surveys)', '… are readily accessible to researchers and easy to collect']",['None of the above'],"['Political elections (e.g. voting behavior)', 'Economic forecasting', 'Presidential approval ratings', 'Health topics (e.g. spread of diseases)', 'Well-being and economic satisfaction', 'Communication (e.g. spread of opinions and hate-speech)', 'Public sentiment (e.g. environment-related concerns)', 'News consumption (e.g. sharing of misinformation)', 'Social networks']",3,0,9,'Ethical approval' means that the experiment is morally sound and not harmful to those who participate in it in any way.,Completely acceptable,,,Completely acceptable,,,Completely acceptable,,,Completely acceptable,,,Not at all important,Not at all important,Moderately important,Not at all important,Moderately important,Slightly important,Slightly important,Slightly important,Moderately important,,7.0,5.0,6.0,2.0,1.0,3.0,4.0,"usefulness - is the study or experiment actually useful in the sense that its results or process is beneficial to those in the study or to people outside of it, aside from the researchers?",8.0,,,,
392,True,747.0,Facebook,27.0,Male,White / Caucasian,Highschool,Very conservative,Extremely aware,"['… reflect events in real-time and can be collected continuously over time', '… often capture social relationships not found using traditional methods (e.g. surveys)']","['Creating fake accounts (""bots"")']",['Political elections (e.g. voting behavior)'],2,1,1,If their methods are right or wrong ,Completely acceptable,"i think it is acceptable, no harm was done and the hate speech was taken down",,Completely acceptable,"im not sure what the point of this research was, to send a message to a person who is right leaning and doesn't believe fact checkers?",,Somewhat acceptable,i dont like the fact they wanted to install a program for viewing the users webpage history,,Somewhat unacceptable,i dont like the thought of every post i make containing something political is labeled as false instantly before even being reviewed,,Moderately important,Not at all important,Slightly important,Slightly important,Moderately important,Very important,Very important,Very important,Very important,"i like a human intervention instead of bots sending messages automatically saying something might be fake fact-checked altho good, has its limitations",4.0,1.0,7.0,6.0,5.0,2.0,3.0,,1.0,,10.0,,10.0
393,True,1227.0,Reddit,42.0,Male,Mixed race,Bachelor's degree,Very liberal,Very aware,"['… are large and can contain millions of data points', '… reflect events in real-time and can be collected continuously over time', '… are naturalistic in that they do not require researchers to directly interact with research volunteers', '… often capture social relationships not found using traditional methods (e.g. surveys)', '… are readily accessible to researchers and easy to collect']","['Privately messaging users', 'Creating fake accounts (""bots"")', 'Secretly changing the content of what users see']","['Political elections (e.g. voting behavior)', 'Economic forecasting', 'Presidential approval ratings', 'Health topics (e.g. spread of diseases)', 'Well-being and economic satisfaction', 'Communication (e.g. spread of opinions and hate-speech)', 'Public sentiment (e.g. environment-related concerns)', 'News consumption (e.g. sharing of misinformation)', 'Social networks']",3,1,9,I think ethical approval means that the researcher is asserting and promising that they will followed accepted ethical standards of research according to the academic community and university.,Somewhat unacceptable,"participants were not aware they were part of a research study and i believe this always makes the study unethical if social media is involved i think the fact that the researchers were using human accounts is a bit more ethical, however their replies were calculated and addressing someone publicly rather than part of organic discourse",,Somewhat unacceptable,"the participants should have been made aware they were part of a study i think the use of private messages is more acceptable, however unsolicited messages themselves are unethical",,Somewhat unacceptable,i do not like encouraging people who completed the survey to participate in politics and definitely not when they are steered to a specific side i also think asking users to install browser extensions is unethical as it is hard for users to know the extent they are potentially being tracked and if the extensions have security issues,what was collected by the extension would be valuable,Completely unacceptable,"i think consent should always be required when someone is part of an experiment they do not necessarily have to know certain details of the experiment if they are necessary to conduct a proper experiment, however they do need to know about what data is being collected and any risks i think blindly addressing users in a public forum like this is and also adding bots to that equation is unethical",,Extremely important,Moderately important,Not at all important,Moderately important,Extremely important,Extremely important,Extremely important,Not at all important,Extremely important,"data retention policy would be particularly important considering laws in various countries around this, especially with regard to private data",5.0,1.0,6.0,3.0,2.0,7.0,4.0,,,,,,
394,True,862.0,Facebook,34.0,Male,White / Caucasian,Bachelor's degree,Very liberal,Slightly aware,"['… are large and can contain millions of data points', '… are naturalistic in that they do not require researchers to directly interact with research volunteers', '… often capture social relationships not found using traditional methods (e.g. surveys)', '… are readily accessible to researchers and easy to collect']","['Privately messaging users', ""Publicly posting on users' profiles"", 'Creating fake accounts (""bots"")']","['Political elections (e.g. voting behavior)', 'Well-being and economic satisfaction', 'Communication (e.g. spread of opinions and hate-speech)', 'Public sentiment (e.g. environment-related concerns)', 'News consumption (e.g. sharing of misinformation)']",2,3,5,I think it means getting an outside party (i.e. an IRB) to examine what the researchers plan to do and judge whether or not it has a likelihood of causing harm to participants or other individuals.,Completely acceptable,i have no concerns they used the social media platform essentially in the same way that any other person might use it,,Completely acceptable,"besides not making participants aware of their participation in the study, i have no thoughts or concerns about this study",,Completely acceptable,"no ethical concerns, but the choice that the participants were given about compensation seems silly to me while it may have no effect, it's unnecessarily creating 3 groups of participants before the study even starts, possibly introducing confounding variables related to their perceptions of their paymentcompensation",,Somewhat acceptable,"since it is hard to know what level of ""toxicity"" a person was at, and since the behavior of the researchers actually increased these levels in individuals, it may cause some level of harm to the ""participants"" or others",,Slightly important,Extremely important,Not at all important,Very important,Slightly important,Moderately important,Not at all important,Not at all important,Moderately important,,2.0,7.0,3.0,1.0,5.0,4.0,6.0,,,,,,
395,True,1344.0,Reddit,49.0,Male,White / Caucasian,Master's degree or above,Very liberal,Not at all aware,"['… are large and can contain millions of data points', '… reflect events in real-time and can be collected continuously over time', '… are naturalistic in that they do not require researchers to directly interact with research volunteers', '… often capture social relationships not found using traditional methods (e.g. surveys)', '… are readily accessible to researchers and easy to collect']","['Creating fake accounts (""bots"")', 'Secretly changing the content of what users see']","['Political elections (e.g. voting behavior)', 'Presidential approval ratings', 'Well-being and economic satisfaction', 'Communication (e.g. spread of opinions and hate-speech)', 'Public sentiment (e.g. environment-related concerns)', 'News consumption (e.g. sharing of misinformation)', 'Social networks']",3,0,7,"Some sort of standard.  Maybe that includes not using deception or other, well, unethical behavior.  Like hacking accounts, misrepresenting facts, etc. ",Somewhat acceptable,i feel generally ok with it since it's trying to reduce toxicity but i don't know if that's a good enough reason to bot  i'm not sure,,Somewhat acceptable,something feels off from it but i fail to see what harm can come of this  again maybe the lack of consent  maybe if it's revealed to them later?  idk,,Completely acceptable,everyone was told everything up front and participation was voluntary,,Somewhat acceptable,"kind of a gray area  while it sounds sinister that people were unknowingly part of an experiment, it's not like they were subjected to torture or anything  and i think there is value in finding out how conspiracy theorists react to facts  i'm all for educating the general populace any way we can",,Very important,Slightly important,Very important,Not at all important,Not at all important,Moderately important,Moderately important,Very important,Very important,were there any assurances the subjects they were studying weren't themselves also bots?,4.0,7.0,6.0,3.0,2.0,5.0,1.0,,8.0,,,,
396,True,645.0,Facebook,31.0,Female,White / Caucasian,Master's degree or above,Very liberal,Extremely aware,"['… are large and can contain millions of data points', '… reflect events in real-time and can be collected continuously over time', '… are readily accessible to researchers and easy to collect']","['Creating fake accounts (""bots"")']","['Political elections (e.g. voting behavior)', 'Communication (e.g. spread of opinions and hate-speech)', 'Public sentiment (e.g. environment-related concerns)', 'News consumption (e.g. sharing of misinformation)', 'Social networks']",1,1,5,"Ethical approval involves a thorough review of the study by an IRB (if this is an academic institution). This IRB reviews the proposed study with the goal of analyzing the risks and benefits of the proposed study to future participants. If the risks seem to outweigh the benefit, or it appears that the procedures will cause undue harm to participants, it is rejected or revisions are requested.",Somewhat acceptable,"although this involves some form of deception, it seems that this was beneficial to the users and platform overall",,Neutral,"the participants did not provide informed consent however, the study did have a positive impact",,Neutral,"this study involved informed consent, but the compensation seemed minimal when considering the tracking of online activity",,Somewhat unacceptable,the participants were not afforded informed consent and it seems like the study had an overall negative impact,,Moderately important,Slightly important,Moderately important,Very important,Slightly important,Slightly important,Extremely important,Very important,Slightly important,,6.0,1.0,4.0,3.0,7.0,2.0,5.0,,,,,,
397,True,1454.0,Facebook,46.0,Male,White / Caucasian,Highschool,Slightly conservative,Not at all aware,"['… are large and can contain millions of data points', '… reflect events in real-time and can be collected continuously over time', '… are naturalistic in that they do not require researchers to directly interact with research volunteers', '… often capture social relationships not found using traditional methods (e.g. surveys)', '… are readily accessible to researchers and easy to collect']","['Creating fake accounts (""bots"")']","['Political elections (e.g. voting behavior)', 'Presidential approval ratings', 'Communication (e.g. spread of opinions and hate-speech)', 'Public sentiment (e.g. environment-related concerns)', 'Social networks']",3,1,5,The people that are having their information collected need to be advised that somebody is actually using their personal or private information for a study. It should not be collected and used without the users consent. The institution needs to make sure that the information collected is not something that a poster has shared with only certain people in mind.,Somewhat acceptable,"if it is done publicly, simply replying to somebody else's hate speech should be fair game because the users have exposed their toxic tweets to everybody else in public i don't see a problem with researchers using and gathering information that is publicly available however, they are some what manipulating the users in pointing out the toxicity","people who post toxic or hateful messages in public are leaving themselves open to scrutiny, they should not assume that their information is anonymous",Somewhat acceptable,"a private message doesn't require the user to respond, they can simply ignore if they are not interested in sharing their opinion there's no harm in asking somebody their opinion, but the information gathered needs to be anonymous","i suspect if the people contacted knew that their answers were going to be part of a research study, they would be more likely to give an answer that they thought the researcher was looking for instead of their own accurate personal opinion",Somewhat acceptable,"if people know that they are being watched, they are going to click on political advertisements that they believe the researchers are expecting them to if they were not knowingly being tracked, they might not click on the same political posts",i think the information is going to be skewed based upon what the user thinks the researcher is looking for they are also more likely to click on political sites because they want to make sure that the researcher is gathering enough data from them,Somewhat unacceptable,"the researcher should not be using fakebot accounts trying to fool the twitter users they are exposing people to false information, one of the biggest problems of sharing news on social media is that there is so much ""fake news""",researchers should not be spreading fake news in the name of research,Extremely important,Extremely important,Extremely important,Not at all important,Extremely important,Very important,Very important,Extremely important,Very important,the users would have to be monitored without their knowing it in order for the conclusion of the research to be accurate knowing me are being watched might skew their social media behavior towards what they believe the researcher is looking for,6.0,4.0,3.0,1.0,2.0,5.0,7.0,carrying out the study in a way that it is not going to be skewed based upon what the user believes the researcher is looking for,8.0,"at the conclusion, the user should have the option to have their data dismissed",9.0,the user should be given the results of the study when it is over,10.0
398,True,815.0,Facebook,55.0,Male,White / Caucasian,Highschool,Slightly conservative,Extremely aware,"['… are large and can contain millions of data points', '… reflect events in real-time and can be collected continuously over time', '… often capture social relationships not found using traditional methods (e.g. surveys)', '… are readily accessible to researchers and easy to collect']","['Privately messaging users', ""Publicly posting on users' profiles"", 'Creating fake accounts (""bots"")', 'Secretly changing the content of what users see']","['Political elections (e.g. voting behavior)', 'Economic forecasting', 'Presidential approval ratings', 'Health topics (e.g. spread of diseases)', 'Well-being and economic satisfaction', 'Communication (e.g. spread of opinions and hate-speech)', 'Public sentiment (e.g. environment-related concerns)', 'News consumption (e.g. sharing of misinformation)', 'Social networks']",2,2,9,"It means absolutely nothing. The term ethics has become extremely subjective, just as all language and words foolishly have, and this is one that modern society has especially reduced into nothingness. Adult children love to play semantics games, rendering words that indicate actual, REAL virtue and justice completely meaningless.",Neutral,"i would need to know more about this to decide this issue, and you certainly need to pay a lot more for what you are asking",,Neutral,"i don't see the point of this most of the ""research"" you are referring to is random and pointless this is a waste of time",,Completely acceptable,it is always ethically rational to entertain opposing viewpoints,,Neutral,"the fact that you used the term ""quality"" shows automatically that you are attemtpting to use bias in conducting scientific research, making your points meaningless, so i have no idea how to judge what you think is quality and not quality way too vague",,Moderately important,Not at all important,Very important,Moderately important,Slightly important,Slightly important,Not at all important,Very important,Slightly important,"you have not elaborated enough on enough of these aspects for us to consider them, because you are making a thoroughly bizarre assumption that we are all experts on social media research and you don't really need to educate us on it first this is a very poorly conducted study",4.0,2.0,5.0,7.0,3.0,1.0,6.0,,,,,,
399,True,894.0,Reddit,35.0,Male,White / Caucasian,Bachelor's degree,Very conservative,Extremely aware,"['… are large and can contain millions of data points', '… are naturalistic in that they do not require researchers to directly interact with research volunteers', '… often capture social relationships not found using traditional methods (e.g. surveys)']","['Privately messaging users', ""Publicly posting on users' profiles"", 'Creating fake accounts (""bots"")', 'Secretly changing the content of what users see']","['Political elections (e.g. voting behavior)', 'Presidential approval ratings', 'Health topics (e.g. spread of diseases)', 'Well-being and economic satisfaction', 'Communication (e.g. spread of opinions and hate-speech)', 'Public sentiment (e.g. environment-related concerns)', 'News consumption (e.g. sharing of misinformation)', 'Social networks']",3,2,8,They go over their experiment and their methods for performing the experiment.  It's looked over by other groups and gets approval that the methods are ethical and fair for the participants.,Somewhat acceptable,the definition of hate speech is designed and created to target certain political groups and opinions,,Somewhat unacceptable,"another study deemed conservative viewpoints as unfactual, based on biased and untrustworthy political leaning fact checkers  the goals of these experiments are clearly just as untrustworthy and biased",None,Somewhat acceptable,,,Somewhat unacceptable,"again, fact checkers are run by biased and politicised groups and cannot be trusted  they are wrong more than not, and are used to target certain groups",,Very important,Moderately important,Very important,Very important,Slightly important,Slightly important,Moderately important,Slightly important,Very important,,1.0,2.0,6.0,4.0,5.0,7.0,3.0,,,,,,
400,True,1177.0,Twitter,38.0,Female,White / Caucasian,Associate's degree,Very liberal,Extremely aware,"['… are large and can contain millions of data points', '… reflect events in real-time and can be collected continuously over time', '… are naturalistic in that they do not require researchers to directly interact with research volunteers', '… often capture social relationships not found using traditional methods (e.g. surveys)', '… are readily accessible to researchers and easy to collect']","['Privately messaging users', ""Publicly posting on users' profiles"", 'Creating fake accounts (""bots"")', 'Secretly changing the content of what users see']","['Political elections (e.g. voting behavior)', 'Economic forecasting', 'Presidential approval ratings', 'Health topics (e.g. spread of diseases)', 'Well-being and economic satisfaction', 'Communication (e.g. spread of opinions and hate-speech)', 'Public sentiment (e.g. environment-related concerns)', 'News consumption (e.g. sharing of misinformation)', 'Social networks']",3,2,9,"I believe ethical approval means ensuring the experiment causes no undue harm to the participants (aware or unaware), social groups, etc and is done with the intent of learning more about the topic they are researching.",Somewhat acceptable,same as the prior experiment and creating a human-operated anon acct,,Somewhat acceptable,"some of same concerns from the previous twitter experiment mentioned - mostly around the ""then the researchers created human-operated anonymous twitter accounts"" - because many users are now hyperaware of fakebotsock accounts and often will not respond to them the same way someone that is an obvious established account",,Completely acceptable,"no concerns - users were advised they would be participating in the study, were compensated, and weren't presented information from an unknown source",,Somewhat acceptable,"many of the individuals that post false claims are often suspicious and paranoid individuals who won't trust certified fact checkers if findings go against what the original poster believes many people believe their bots look like they are real people but don't take into account the profile creation date, number of tweets, content of tweets, accounts being followedfollowing, etc when making these accounts so, this likely increased the original posters belief in false claims because by having an automated account reply to these users - no matter how human looking they may appear - it further cemented beliefs they already holdi perform a lot of digital research for activism groups and i can spot a bot attempting to look human in under a minute - most normal users can do so in under 15 minutes if determined",i would like to know example content of the tweets and be shown an example of the bot accounts - it's hard to know exactly how individuals would react to someone pointing out their wrong without knowing the profile of the person pointing out the error,Extremely important,Very important,Very important,Extremely important,Extremely important,Extremely important,Moderately important,Very important,Very important,one of my biggest concerns is around the type of manipulation facebook did when changing people's timelines to determine if being shown more negative news impacts their mental health it is unacceptable to manipulate people in any way that could harm them in that manner,5.0,6.0,3.0,4.0,1.0,2.0,7.0,methods used to interact with participants whether awareunaware and the expected knowledge of social platforms for modern usersie - using automated bot accounts will likely skew experiment results due to intelligent users identifying bots versus real humans,5.0,,,,
401,True,1974.0,Facebook,42.0,Female,White / Caucasian,Highschool,Slightly liberal,Not at all aware,"['… are large and can contain millions of data points', '… are naturalistic in that they do not require researchers to directly interact with research volunteers']",['None of the above'],"['Political elections (e.g. voting behavior)', 'Economic forecasting', 'Presidential approval ratings', 'Health topics (e.g. spread of diseases)', 'Well-being and economic satisfaction', 'Communication (e.g. spread of opinions and hate-speech)', 'Public sentiment (e.g. environment-related concerns)', 'News consumption (e.g. sharing of misinformation)', 'Social networks']",2,0,9,I think ethical approval means that they will protect my information and do so in a way that everyone's welfare is protected.,Somewhat unacceptable,"you are targeting hate speech, hey, everybody has a bad day  how did you get the info on these people  and did they agree to have you spy on their activity for your research  you also created fake accounts, not cool!!!  you paid no-one except maybe twitter for the info  completely unethical",this is completely unethical  who gave you the info on the 1000 posts  no one gave you info to follow them with fake accounts  no one was paid and the subjects did not know you were doing this,Completely unacceptable,the people you used were not aware of the study  you sent them info with out telling them what was going on  you did not pay them either for your benefit,completely unethical  people should be aware if they are part of a study  how did you find these people to start off with?  is twitter selling information?,Neutral,,"i'm not sure who would want the results, but to either take money or get the results most would take the money  other survey makers would take the results just because it's free information",Completely unacceptable,"fake accounts, users were unaware they were part of a study and where did they get the info so quickly?  is twitter selling info?  i agree with fact-checking, but you cannot study someone or their accounts with out their permission",completely unethical  customers were unaware of the study and fake accounts were made  no one was compensated or aware,Extremely important,Extremely important,Extremely important,Extremely important,Extremely important,Extremely important,Extremely important,Moderately important,Extremely important,"where do they get their subjects, especially such a high number  it leads me to believe that they are selling my info  i don't want to be part of a study that i am unaware of  if i'm going to be part of a study, i want to get paid  these fake accounts are against user standards and rules",7.0,2.0,4.0,3.0,5.0,6.0,1.0,explain where they get the info on people to study  did they pay for it?,1.0,,,,
402,True,964.0,Facebook,32.0,Male,White / Caucasian,Bachelor's degree,Slightly liberal,Very aware,"['… are large and can contain millions of data points', '… reflect events in real-time and can be collected continuously over time', '… often capture social relationships not found using traditional methods (e.g. surveys)', '… are readily accessible to researchers and easy to collect']","['Creating fake accounts (""bots"")']","['Political elections (e.g. voting behavior)', 'Presidential approval ratings', 'Well-being and economic satisfaction', 'Communication (e.g. spread of opinions and hate-speech)', 'News consumption (e.g. sharing of misinformation)', 'Social networks']",2,1,6,Clearance and approval that states what they do does not directly invade someone's privacy and mishandles personal details.,Somewhat unacceptable,the participants were not aware of them being a part of this study when their data was collected,,Somewhat unacceptable,the participants were not aware of the study and did not give consent for this type of data to be used,,Somewhat unacceptable,i feel like recording browser history and facebook posts would be a breach of privacy for these participants,,Completely unacceptable,the participants were unaware their data was being collected for this study,the outcome of this study has also resulted in negative behavior by the participants due to the experiment,Slightly important,Slightly important,Slightly important,Slightly important,Slightly important,Moderately important,Very important,Extremely important,Very important,,7.0,2.0,5.0,4.0,1.0,6.0,3.0,,,,,,
403,True,999.0,Reddit,32.0,Female,White / Caucasian,Highschool,Slightly conservative,Very aware,"['… reflect events in real-time and can be collected continuously over time', '… often capture social relationships not found using traditional methods (e.g. surveys)', '… are readily accessible to researchers and easy to collect']","['Privately messaging users', 'Creating fake accounts (""bots"")', 'Secretly changing the content of what users see']","['Political elections (e.g. voting behavior)', 'Economic forecasting', 'Presidential approval ratings', 'Health topics (e.g. spread of diseases)', 'Well-being and economic satisfaction', 'Communication (e.g. spread of opinions and hate-speech)', 'Public sentiment (e.g. environment-related concerns)', 'News consumption (e.g. sharing of misinformation)', 'Social networks']",1,1,9,"I think ethical approval means having their experiments pre examined in order to determine if the method of action is ethical or unethical. If it is deemed ethical, it is approved.",Somewhat acceptable,people being unaware of being in a research study,i find it somewhat ethical because the experiment helped to reduce hate speech on twitter,Somewhat acceptable,,i find it acceptable because the messages helped people to post more accurate information,Somewhat unacceptable,"i think it's slightly unethical to have people ""like"" a news station if they didn't already",the experiment didn't change anyone's political views,Somewhat acceptable,people being unaware of being in the study,i find it acceptable because this method is helping to slow the spread of misinformation,Very important,Very important,Extremely important,Moderately important,Moderately important,Moderately important,Moderately important,Extremely important,Very important,having a wide variety of participants,7.0,2.0,5.0,6.0,3.0,4.0,1.0,None,8.0,,,,
404,True,706.0,Twitter,34.0,Female,White / Caucasian,Bachelor's degree,Very liberal,Moderately aware,"['… are large and can contain millions of data points', '… reflect events in real-time and can be collected continuously over time', '… are naturalistic in that they do not require researchers to directly interact with research volunteers', '… are readily accessible to researchers and easy to collect']","['Creating fake accounts (""bots"")']","['Political elections (e.g. voting behavior)', 'Economic forecasting', 'Presidential approval ratings', 'Health topics (e.g. spread of diseases)', 'Well-being and economic satisfaction', 'Communication (e.g. spread of opinions and hate-speech)', 'Public sentiment (e.g. environment-related concerns)', 'News consumption (e.g. sharing of misinformation)', 'Social networks']",2,1,9,It needs to be cleared in accordance with their guidelines.,Somewhat acceptable,,,Somewhat unacceptable,sending unsolicited dms is weird,,Somewhat unacceptable,,,Neutral,,,Moderately important,Slightly important,Very important,Slightly important,Moderately important,Very important,Moderately important,Moderately important,Moderately important,,4.0,7.0,3.0,1.0,2.0,5.0,6.0,,0.0,,0.0,,0.0
405,True,1229.0,Facebook,46.0,Male,White / Caucasian,Associate's degree,Very conservative,Extremely aware,"['… reflect events in real-time and can be collected continuously over time', '… are naturalistic in that they do not require researchers to directly interact with research volunteers', '… often capture social relationships not found using traditional methods (e.g. surveys)', '… are readily accessible to researchers and easy to collect']","['Privately messaging users', ""Publicly posting on users' profiles"", 'Creating fake accounts (""bots"")', 'Secretly changing the content of what users see']","['Political elections (e.g. voting behavior)', 'Health topics (e.g. spread of diseases)', 'Communication (e.g. spread of opinions and hate-speech)', 'Public sentiment (e.g. environment-related concerns)', 'News consumption (e.g. sharing of misinformation)']",2,2,5,"It is most likely an approval that is given after a review of what data is to be collected, who it is going to be collected from, the reasoning behind harvesting the data is considered, and reviewing what issues could arise from the collection of data.",Completely unacceptable,engaging with someone on social media under false pretenses and with ulterior motives is wrong in my opinion,"what is the researchers defining as ""hate speech""? some people view anything that goes against their own ideology as hate speech",Completely unacceptable,the whole study is biased towards those of one political ideology and the study was done without the knowledge or consent of the participants,,Somewhat acceptable,the participants were informed they were part of a study and volunteered to install the browser extension,,Somewhat unacceptable,although the responses were automated they gave the recipient the false impression that they were speaking to a real person,"the researchers relied on ""fact checkers"" to determine if the information was ""fake"" or not if there existed a bias or margin of error in the fact checker's process then the researchers would be working with wrong information themselves",Extremely important,Extremely important,Extremely important,Extremely important,Extremely important,Very important,Extremely important,Very important,Extremely important,,5.0,7.0,6.0,2.0,3.0,4.0,1.0,,,,,,
406,True,631.0,Twitter,31.0,Male,White / Caucasian,Bachelor's degree,Slightly liberal,Moderately aware,"['… reflect events in real-time and can be collected continuously over time', '… often capture social relationships not found using traditional methods (e.g. surveys)', '… are readily accessible to researchers and easy to collect']","['Creating fake accounts (""bots"")']","['Health topics (e.g. spread of diseases)', 'Well-being and economic satisfaction', 'Communication (e.g. spread of opinions and hate-speech)', 'Public sentiment (e.g. environment-related concerns)', 'News consumption (e.g. sharing of misinformation)', 'Social networks']",1,1,6,Ethical approval means that the experiment adheres to basic decency standards and is not overly manipulative or misleading.  This ensures no harm comes from the experiment.,Completely acceptable,"i don't find this to be an egregious act and am completely fine with twitter users interacting with bots, provided their intention is not to sow discord",,Completely acceptable,this seems ethical and not an invasion of privacy (in my opinion),,Somewhat acceptable,"i find this to be somewhat acceptable, assuming the participants were fully aware that the extension was tracking their browsing history",,Completely acceptable,"i find this acceptable as it is a study (and potential effort) to reduce misinformation, which is a legitimate problem",,Slightly important,Slightly important,Very important,Moderately important,Slightly important,Moderately important,Extremely important,Slightly important,Slightly important,,7.0,1.0,6.0,3.0,2.0,4.0,5.0,,,,,,
407,True,924.0,Facebook,57.0,Male,White / Caucasian,Master's degree or above,Very conservative,Slightly aware,"['… are large and can contain millions of data points', '… reflect events in real-time and can be collected continuously over time', '… are readily accessible to researchers and easy to collect']","['Creating fake accounts (""bots"")']","['Political elections (e.g. voting behavior)', 'Economic forecasting', 'Health topics (e.g. spread of diseases)', 'Communication (e.g. spread of opinions and hate-speech)', 'Public sentiment (e.g. environment-related concerns)', 'News consumption (e.g. sharing of misinformation)', 'Social networks']",1,1,7,That the research they are doing and the data collected will not be used in a way to have a negative affect on others.,Somewhat unacceptable,those that received the messages were deceived  never trust messages from someone you do not know,None,Somewhat unacceptable,"kind of deceiving but on social media, everything is open game",should disclose in message they are doing study,Completely acceptable,this is the right way to conduct a study online,,Neutral,does not seem right but people should be aware how their information is being used,,Very important,Slightly important,Moderately important,Slightly important,Not at all important,Very important,Very important,Moderately important,Slightly important,disclosure of the study  purpose of the study,7.0,3.0,5.0,1.0,4.0,6.0,2.0,"the social media service (twittet, facebook, etc) knows the data is being collected",,None,,size of the study  how many people are they collecting data on,
408,True,875.0,Facebook,70.0,Female,White / Caucasian,Highschool,Slightly liberal,Very aware,"['… are large and can contain millions of data points', '… reflect events in real-time and can be collected continuously over time', '… are naturalistic in that they do not require researchers to directly interact with research volunteers', '… often capture social relationships not found using traditional methods (e.g. surveys)', '… are readily accessible to researchers and easy to collect']","['Privately messaging users', ""Publicly posting on users' profiles"", 'Creating fake accounts (""bots"")']","['Political elections (e.g. voting behavior)', 'Communication (e.g. spread of opinions and hate-speech)', 'Public sentiment (e.g. environment-related concerns)', 'News consumption (e.g. sharing of misinformation)', 'Social networks']",3,3,5,They submit their proposed study or experiment to a board at their institution for consideration and get permission if it passes their standards.,Somewhat acceptable,this seems to manipulate the results of the study,,Completely acceptable,,,Somewhat unacceptable,this definitely seems to be manipulating the results with promises of gifts,,Completely acceptable,,,Very important,Extremely important,Very important,Very important,Not at all important,Very important,Not at all important,Very important,Not at all important,,4.0,5.0,6.0,1.0,3.0,7.0,2.0,,,,,,
409,True,1901.0,Facebook,50.0,Female,White / Caucasian,Bachelor's degree,Very liberal,Moderately aware,['… are large and can contain millions of data points'],['None of the above'],"['Political elections (e.g. voting behavior)', 'Economic forecasting', 'Presidential approval ratings', 'Health topics (e.g. spread of diseases)', 'Well-being and economic satisfaction', 'Communication (e.g. spread of opinions and hate-speech)', 'Public sentiment (e.g. environment-related concerns)', 'News consumption (e.g. sharing of misinformation)', 'Social networks']",1,0,9,"I would think ethical approval means putting together a proposal including purpose, the hypothesis, support for the theory or whatever you're trying to prove or disprove, then also describing or outlining the methods you are planning on using in order to obtain your data. You may also have to include the proposed questions you are going to ask to make sure the wording is appropriate. You may also have to include any information at the end if you've used deception in order to get your information like using an article that you've made up or fake websites or graphics that were made up in order to get the data that you needed for the experiment.",Somewhat unacceptable,"it's better because it's using a human operated twitter account but again, i would think part of ethically acceptable is the participant knowing, agreeing, and consenting to participating in the study they are also being manipulated which i mean happens in daily life, probably happens in research, but again, doesn't make it ethically acceptable",,Somewhat unacceptable,"again, the users were sent a private unsolicited message and asked to respond to it the participants were unaware that they were taking part in an experiment nor were they asked for their consent i've done a ton like in the thousands of experiments between prolific and other websites and i would say most if not all of the college university type institutions would have a consent form on them just saying all this fake account non human stuff probably exists and are probably utilized everyday in research and marketing etc but it doesn't mean it's ethically acceptable",,Completely acceptable,"sounds good participants were made aware, offered compensation woohoo which is always appreciated",,Somewhat unacceptable,"well there is some deception going on without letting the participants know that they are participants oh consent i meant to add consent to the other question anyway, the participants never were told they were participating in an experiment they weren't asked if they wanted to participate or if they wanted their data or information to be used they thought there was a real person at the other end of that twitter account so there might be better ways to obtain the information while still getting the information and or data that the researched needed to get",,Very important,Very important,Moderately important,Moderately important,Very important,Very important,Very important,Moderately important,Very important,,4.0,1.0,7.0,3.0,6.0,5.0,2.0,,,,,,
410,True,1095.0,Facebook,21.0,Female,Hispanic,Bachelor's degree,Slightly liberal,Extremely aware,"['… are large and can contain millions of data points', '… reflect events in real-time and can be collected continuously over time', '… are naturalistic in that they do not require researchers to directly interact with research volunteers', '… often capture social relationships not found using traditional methods (e.g. surveys)', '… are readily accessible to researchers and easy to collect', '… are unaffected by the way social media platforms work']","[""Publicly posting on users' profiles"", 'Creating fake accounts (""bots"")']","['Political elections (e.g. voting behavior)', 'Economic forecasting', 'Presidential approval ratings', 'Health topics (e.g. spread of diseases)', 'Well-being and economic satisfaction', 'Communication (e.g. spread of opinions and hate-speech)', 'Public sentiment (e.g. environment-related concerns)', 'News consumption (e.g. sharing of misinformation)', 'Social networks']",2,2,9,The convincing of credibility and trustworthiness of an author or communicator. ,Somewhat acceptable,i believe this was a smart experiment,,Somewhat acceptable,why were these specific twitter users used for this research experiment?,,Somewhat acceptable,the experiment research did not have the best outcome since many people did not change their political views,,Neutral,i do not understand the main goal of this research experiment,,Extremely important,Very important,Extremely important,Moderately important,Very important,Very important,Extremely important,Extremely important,Extremely important,,7.0,3.0,2.0,6.0,1.0,4.0,5.0,understanding the limits of the internet,8.0,researchers must maintain participant confidentiality,10.0,"research misconduct, such as:fabrication, falsification, and plagiarism",10.0
411,True,2200.0,Twitter,33.0,Male,White / Caucasian,Highschool,Neutral/ Neither conservative or liberal,Not at all aware,"['… are large and can contain millions of data points', '… reflect events in real-time and can be collected continuously over time', '… are naturalistic in that they do not require researchers to directly interact with research volunteers', '… often capture social relationships not found using traditional methods (e.g. surveys)', '… are readily accessible to researchers and easy to collect', '… are always representative of people’s offline behavior', '… are unaffected by the way social media platforms work']","['Privately messaging users', ""Publicly posting on users' profiles"", 'Creating fake accounts (""bots"")', 'Secretly changing the content of what users see']","['Political elections (e.g. voting behavior)', 'Economic forecasting', 'Presidential approval ratings', 'Health topics (e.g. spread of diseases)', 'Well-being and economic satisfaction', 'Communication (e.g. spread of opinions and hate-speech)', 'Public sentiment (e.g. environment-related concerns)', 'News consumption (e.g. sharing of misinformation)', 'Social networks']",1,2,9,Ethical approval could show that the research is being carried out in an ethical and practical way. It could put rules in place such as ensuring the safety of both children and adults.,Neutral,"while the participants had no knowledge of being in the study, their posts are public domain and could be observed by anyone the researchers carefully planned what they were going to say and analyzed the results if we were smarter we would all do this a little more often",,Neutral,i don't see a problem with it as long as there were no risks involved,,Completely acceptable,the participants were informed and received a reward for participating,,Neutral,"while i think that it is a good study, if it encouraged participants to become angry then it might be an ethical concern",,Very important,Extremely important,Moderately important,Extremely important,Extremely important,Slightly important,Extremely important,Very important,Very important,if it was consistent behavior or a one time thing,6.0,7.0,5.0,4.0,2.0,3.0,1.0,,,,,,
412,True,1010.0,Reddit,29.0,Male,White / Caucasian,Highschool,Slightly conservative,Slightly aware,"['… are large and can contain millions of data points', '… reflect events in real-time and can be collected continuously over time', '… are naturalistic in that they do not require researchers to directly interact with research volunteers', '… are readily accessible to researchers and easy to collect']","['Privately messaging users', ""Publicly posting on users' profiles"", 'Creating fake accounts (""bots"")']","['Economic forecasting', 'Presidential approval ratings', 'Health topics (e.g. spread of diseases)', 'Communication (e.g. spread of opinions and hate-speech)', 'Public sentiment (e.g. environment-related concerns)', 'News consumption (e.g. sharing of misinformation)', 'Social networks']",2,3,7,I believe ethical approval means that the institutions make sure that there are no moral rules or codes being broken when the researchers run their experiments. ,Neutral,,,Neutral,,,Completely acceptable,i think that this is a good study to see how certain news can affect people but i believe the study was too short,,Somewhat unacceptable,this study feels more like manipulating the users of tweeter,,Very important,Slightly important,Moderately important,Not at all important,Very important,Very important,Very important,Moderately important,Very important,,5.0,1.0,3.0,7.0,2.0,6.0,4.0,,,,,,
413,True,634.0,Twitter,35.0,Female,African-American,Master's degree or above,Very liberal,Very aware,"['… are large and can contain millions of data points', '… reflect events in real-time and can be collected continuously over time', '… often capture social relationships not found using traditional methods (e.g. surveys)', '… are readily accessible to researchers and easy to collect']","['Privately messaging users', 'Creating fake accounts (""bots"")', 'Secretly changing the content of what users see']","['Political elections (e.g. voting behavior)', 'Presidential approval ratings', 'Health topics (e.g. spread of diseases)', 'Well-being and economic satisfaction', 'Communication (e.g. spread of opinions and hate-speech)', 'Public sentiment (e.g. environment-related concerns)', 'News consumption (e.g. sharing of misinformation)', 'Social networks']",2,1,8,They need to ask their instutition if what they are doing is honest and correct. ,Somewhat unacceptable,i think people need to be told there is social engineering by an institute,,Somewhat unacceptable,"again, people should be told they are being researched",None,Somewhat unacceptable,i think people should be told they are a part of an experiment if the data is used,None,Somewhat unacceptable,,,Slightly important,Extremely important,Moderately important,Very important,Moderately important,Very important,Extremely important,Extremely important,Extremely important,"social media does represent the greater populations but when applying the rules of social media to daily interactions, and lifestyle, it can be misleading as representative",7.0,1.0,5.0,2.0,4.0,3.0,6.0,inform participants of study after,2.0,,,,
414,True,626.0,Reddit,43.0,Female,White / Caucasian,Highschool,Very liberal,Not at all aware,"['… are large and can contain millions of data points', '… reflect events in real-time and can be collected continuously over time', '… are naturalistic in that they do not require researchers to directly interact with research volunteers', '… often capture social relationships not found using traditional methods (e.g. surveys)', '… are readily accessible to researchers and easy to collect']","['Privately messaging users', 'Creating fake accounts (""bots"")']","['Presidential approval ratings', 'Well-being and economic satisfaction', 'Communication (e.g. spread of opinions and hate-speech)', 'Public sentiment (e.g. environment-related concerns)', 'News consumption (e.g. sharing of misinformation)', 'Social networks']",3,2,6,"In this case, I think ethical approval means the researchers can convince the decision makers that no adverse affect will be had on the unwitting users of said social media.",Completely acceptable,,,Completely acceptable,,,Completely acceptable,,,Completely acceptable,,,Extremely important,Very important,Extremely important,Not at all important,Moderately important,Not at all important,Not at all important,Very important,Extremely important,"i think as long as their are no adverse effects, it's fine with me",5.0,7.0,4.0,1.0,2.0,3.0,6.0,honesty when disseminating the information,8.0,"must be for positive societal movement, not backwards movement",5.0,all unknowing participants notified of use of their info,9.0
415,True,891.0,Facebook,24.0,Male,White / Caucasian,Bachelor's degree,Neutral/ Neither conservative or liberal,Moderately aware,"['… are large and can contain millions of data points', '… often capture social relationships not found using traditional methods (e.g. surveys)', '… are readily accessible to researchers and easy to collect']","[""Publicly posting on users' profiles"", 'Creating fake accounts (""bots"")', 'Secretly changing the content of what users see']","['Presidential approval ratings', 'Health topics (e.g. spread of diseases)', 'News consumption (e.g. sharing of misinformation)']",1,1,3,I think it means that the research is on an ethical topic that is not unfairly skewed,Completely unacceptable,this is unacceptable because the people were not made aware that these were bots replying,,Somewhat unacceptable,i am concerned that they were privately messaged,,Somewhat acceptable,this study appears to be mildly ethical no major concerns,,Completely unacceptable,they didnt let the participants know that they were participating in a research project,i would not think it is ethical no matter what,Moderately important,Slightly important,Moderately important,Moderately important,Very important,Extremely important,Extremely important,Moderately important,Very important,,3.0,7.0,6.0,1.0,5.0,4.0,2.0,,7.0,,,,
416,True,1483.0,Facebook,70.0,Male,Native-American,Bachelor's degree,Neutral/ Neither conservative or liberal,Not at all aware,"['… are large and can contain millions of data points', '… reflect events in real-time and can be collected continuously over time', '… are naturalistic in that they do not require researchers to directly interact with research volunteers', '… often capture social relationships not found using traditional methods (e.g. surveys)', '… are readily accessible to researchers and easy to collect']",['None of the above'],"['Political elections (e.g. voting behavior)', 'Presidential approval ratings', 'Well-being and economic satisfaction', 'Communication (e.g. spread of opinions and hate-speech)', 'Public sentiment (e.g. environment-related concerns)', 'News consumption (e.g. sharing of misinformation)']",3,0,6,permission that would include not sharing names or places of residence,Somewhat acceptable,need to let people know they are being studied,,Somewhat acceptable,,,Somewhat acceptable,,,Somewhat unacceptable,,,Very important,Slightly important,Extremely important,Very important,Moderately important,Very important,Very important,Extremely important,Extremely important,,4.0,5.0,7.0,2.0,1.0,3.0,6.0,,,,,,
417,True,671.0,Reddit,26.0,Male,Asian - Eastern,Bachelor's degree,Very liberal,Slightly aware,"['… are large and can contain millions of data points', '… reflect events in real-time and can be collected continuously over time', '… are readily accessible to researchers and easy to collect']","['Privately messaging users', 'Creating fake accounts (""bots"")', 'Secretly changing the content of what users see']","['Political elections (e.g. voting behavior)', 'Presidential approval ratings', 'Health topics (e.g. spread of diseases)', 'Communication (e.g. spread of opinions and hate-speech)', 'Public sentiment (e.g. environment-related concerns)', 'News consumption (e.g. sharing of misinformation)']",1,1,6,"To make sure the experiment doesn't violate basic morals. For example, an experiment that involves hacking users or 'doxxing' them would unlikely to be approved.",Completely acceptable,,,Completely acceptable,,,Somewhat acceptable,,,Completely acceptable,,,Moderately important,Moderately important,Very important,Slightly important,Moderately important,Very important,Extremely important,Very important,Moderately important,"my main concern is participant awareness, which was already covered",7.0,3.0,6.0,4.0,1.0,5.0,2.0,,,,,,
418,True,989.0,Facebook,35.0,Female,White / Caucasian,Highschool,Neutral/ Neither conservative or liberal,Slightly aware,"['… are large and can contain millions of data points', '… reflect events in real-time and can be collected continuously over time', '… are naturalistic in that they do not require researchers to directly interact with research volunteers', '… are readily accessible to researchers and easy to collect']",['Privately messaging users'],"['Political elections (e.g. voting behavior)', 'Economic forecasting', 'Presidential approval ratings', 'Public sentiment (e.g. environment-related concerns)', 'Social networks']",2,1,5,I think ethical approval means consent to collect the data.,Completely acceptable,,,Completely acceptable,,,Completely acceptable,,,Completely acceptable,,,Very important,Extremely important,Extremely important,Extremely important,Very important,Slightly important,Moderately important,Moderately important,Extremely important,no all the important aspects have already been mentioned,7.0,6.0,4.0,2.0,1.0,5.0,3.0,,,,,,
419,True,1222.0,Twitter,50.0,Male,White / Caucasian,Bachelor's degree,Slightly liberal,Moderately aware,"['… are large and can contain millions of data points', '… reflect events in real-time and can be collected continuously over time', '… often capture social relationships not found using traditional methods (e.g. surveys)', '… are readily accessible to researchers and easy to collect']","['Privately messaging users', ""Publicly posting on users' profiles""]","['Political elections (e.g. voting behavior)', 'Presidential approval ratings', 'Communication (e.g. spread of opinions and hate-speech)', 'News consumption (e.g. sharing of misinformation)', 'Social networks']",2,2,5,I believe that researchers submit their proposed study to their institution's board of ethics. The board reviews the proposed study for its content and how it will be applied to participants. The board gives ethical approval if the board believes that the study will not result in physical or mental harm to participants. That the study offers no risks beyond those encountered in everyday life.,Completely unacceptable,i believe it's unethical to include people in a research study without telling them about the study beforehand,,Completely unacceptable,"again, i do not like the practice of including people in a research study without telling the people about it the anonymous twitter accounts are also misleading and creepy",,Somewhat acceptable,"i don't like the idea of installing a web browser extension that allows researchers to monitor the online activity of study participants however, if the participants are explicitly told about the extension and reason behind it, and if the participants are given the choice to install the extension or not, then i believe its ethical after all, google and other sites monitor the activity of users",,Completely unacceptable,"i don't like that participants did not know they were part of a research study they should've been given the choice to participate or not also, i don't like that fake, ""human-looking"" accounts were created and that communicated to ""participants"" that's very misleading",,Moderately important,Moderately important,Very important,Moderately important,Extremely important,Very important,Extremely important,Very important,Very important,if the research study uses an anonymous account to communicate with participants which i think is misleading,7.0,2.0,6.0,5.0,1.0,4.0,3.0,,,,,,
420,True,963.0,Twitter,32.0,Female,White / Caucasian,Bachelor's degree,Very liberal,Slightly aware,"['… are large and can contain millions of data points', '… are naturalistic in that they do not require researchers to directly interact with research volunteers', '… often capture social relationships not found using traditional methods (e.g. surveys)', '… are readily accessible to researchers and easy to collect']","['Creating fake accounts (""bots"")', 'Secretly changing the content of what users see']","['Health topics (e.g. spread of diseases)', 'Communication (e.g. spread of opinions and hate-speech)', 'Public sentiment (e.g. environment-related concerns)', 'News consumption (e.g. sharing of misinformation)', 'Social networks']",2,0,5,Maybe that the data is true and they're not manipulating it in any way,Somewhat unacceptable,None,,Neutral,same as the first one - i'm not sure how i feel about the user not being informed,,Somewhat acceptable,,,Neutral,"i'm not sure how i feel about the users not being aware of the study, could be helpful but it also could be hurtful",,Moderately important,Very important,Slightly important,Moderately important,Moderately important,Moderately important,Very important,Moderately important,Moderately important,,4.0,3.0,7.0,6.0,1.0,5.0,2.0,,,,,,
421,True,1015.0,Facebook,23.0,Female,Mixed race,Highschool,Slightly conservative,Moderately aware,"['… are large and can contain millions of data points', '… reflect events in real-time and can be collected continuously over time', '… are naturalistic in that they do not require researchers to directly interact with research volunteers', '… often capture social relationships not found using traditional methods (e.g. surveys)', '… are readily accessible to researchers and easy to collect']","[""Publicly posting on users' profiles""]","['Political elections (e.g. voting behavior)', 'Economic forecasting', 'Presidential approval ratings', 'Health topics (e.g. spread of diseases)', 'Well-being and economic satisfaction', 'Communication (e.g. spread of opinions and hate-speech)', 'Public sentiment (e.g. environment-related concerns)', 'Social networks']",3,1,8,It means approval that gives users free will to choose without feeling forced by any means.,Completely unacceptable,being rude to participants without telling them is wrong on all grounds,they should have told the participants for it to change to ethical,Somewhat unacceptable,the study was an unethical survey,if they had told participants than my verdict would change,Completely acceptable,,as long as they told participants it wouldn't change,Somewhat unacceptable,i understand why the researchers did what they did for valid information,it isn't fully unacceptable because not being a free will study was the only way they could get valid research,Extremely important,Not at all important,Extremely important,Not at all important,Not at all important,Not at all important,Extremely important,Extremely important,Not at all important,,7.0,1.0,5.0,4.0,2.0,6.0,3.0,environmental harm doing the study,8.0,,9.0,,10.0
422,True,2700.0,Reddit,52.0,Male,White / Caucasian,Highschool,Slightly liberal,Moderately aware,"['… are large and can contain millions of data points', '… reflect events in real-time and can be collected continuously over time', '… are naturalistic in that they do not require researchers to directly interact with research volunteers', '… often capture social relationships not found using traditional methods (e.g. surveys)', '… are readily accessible to researchers and easy to collect']","['Privately messaging users', ""Publicly posting on users' profiles""]","['Political elections (e.g. voting behavior)', 'Economic forecasting', 'Presidential approval ratings', 'Health topics (e.g. spread of diseases)', 'Well-being and economic satisfaction', 'Communication (e.g. spread of opinions and hate-speech)', 'Public sentiment (e.g. environment-related concerns)', 'News consumption (e.g. sharing of misinformation)', 'Social networks']",3,2,9,"Hmm, I'm afraid a fuller answer to that could go on for ages and have all kinds of caveats, so I'll attempt a brief answer (and hope I come somewhere close to right): It likely means you're allowed to do just about anything to gather data except outright lie, at least not without providing some sort of information after-the-fact and then allow an opt-out process of some kind. Of course, if data is being gathered anonymously on a social network platform, I'm not altogether sure there would be a satisfactory way to actually contact all the people from which data was gathered in order to inform them after-the-fact, and even if you did, there's no guarantee the same person who was using the keyboard at the time will be the same person who sees/responds-to the after-fact-informing process, or that anyone would respond at all for that matter. Anyway, yeah, lots of caveats ... and I'm not even sure whether I've even come close to correct on any of that as it relates to the question of what ""ethical approval"" means. :/",Completely acceptable,"hmm, interesting -- never knew that sort of thing went on ya'do learn something new everyday! :)side note: you've got a typo up there i'll paste the sentence part here with the typo in [brackets] to make it easier to spot:""identified over one thousand [thousand] twitter users""you've got the word ""thousand"" in there twice if that was on purpose as another way to say ""one million"", then you're fine (although you should probably actually say ""one million"" in that case) otherwise, one of those should be removed","not really i mean, it is the internet, and people are free to interact (or not interact)  -- and no one really knows (or seems to need or want necessarily to know) who they are interacting with at any given time it's the nature of the proverbial beast so taking advantage of that fact isn't unethical necessarily",Somewhat acceptable,"that's good news, although it does seem strange (based on what i see in my own life with the crazies i live around) that right-leaning folks you watched actually attempted to lean into the truth and into reality (instead of running farther and faster away from it ) by actually sharing higher quality news content that gives me a little more hope for humanity! :)",,Somewhat acceptable,"definitely need more research on the tribalism we have going on at the minute in this country (and others for that matter) it's getting very strange out there in the wild, people are becoming more and more strange every day so, yeah, this one, for sure: ethical (at least not unethical anyway)",,Somewhat acceptable,"be careful, your fake data (that was meant for research purposes) might show up some news channels as the real thing, and that could cause some folks to want to go have a ""peaceful tour"" somewhere so they can take souvenirs; including furniture and lives :(","yeah, be careful here too many folks out here in the wild just go on knee-jerk reactions, not thinking, just reacting someone should do a study on the decline in critical thinking skills (it's been declining for decades, if not generations now)",Very important,Very important,Very important,Very important,Moderately important,Very important,Moderately important,Very important,Moderately important,"well, it's such a hotbed of misinformation (and all kinds of other socially unacceptable behaviors -- ironic since it's called ""social media""), that i'm starting to wonder if social media itself isn't the cause of a lot of the badstrangenot-right things going on across the planet (that, and 24-hour news, or an unfortunate combination of both) so, while i'm all for ""more of this please"", i'm also concerned that the research itself could be helping to ""destabilize"" people out there i feel like a lot of them never learned how to be stable in the first place :(",3.0,7.0,4.0,6.0,2.0,5.0,1.0,"i think the above list covers everything if there are more things to consider, they're not coming to mind for me, and i've sat here thinking for awhile (timer is down to 12 minutes left, and i have no idea how many more pages are left in this study, so i should probably stop typing here and carry on so i don't run out of time overall)",1.0,,,,
423,True,1016.0,Facebook,27.0,Male,Asian - Eastern,Bachelor's degree,Slightly liberal,Slightly aware,"['… are large and can contain millions of data points', '… reflect events in real-time and can be collected continuously over time', '… are naturalistic in that they do not require researchers to directly interact with research volunteers', '… often capture social relationships not found using traditional methods (e.g. surveys)', '… are readily accessible to researchers and easy to collect']","['Privately messaging users', 'Creating fake accounts (""bots"")', 'Secretly changing the content of what users see']","['Political elections (e.g. voting behavior)', 'Presidential approval ratings', 'Health topics (e.g. spread of diseases)', 'Well-being and economic satisfaction', 'Communication (e.g. spread of opinions and hate-speech)', 'Public sentiment (e.g. environment-related concerns)', 'News consumption (e.g. sharing of misinformation)']",3,1,7,Ethical approval would indicate that the participants are notified in some kind of way and receive consent for their data to be collected. The study should also be approved by 3rd party to ensure that it doesn't cause harm on the participant while also having some kind of benefit for performing the study. ,Neutral,"technically anyone can message and post like the researchers did, but the users weren't notified of having their data collected the actions that were taken could theoretically be performed by any other individual, but not being notified that an experiment could be an issue",whether consent or debriefing was performed,Neutral,"privately messaging users seems to be a little bit invasive and they may receive more information than they had expected the message could be considered unsolicited, but at the same time, social media websites allow you to message people privately regardless if they are connected or not on one hand, they aren't doing anything that isn't allowed, but at the same time the participant doesn't know if they're part of a study or not",it would depend if they were given some information about being part of the study and how much information is collected on the individual,Completely acceptable,this seems like a fair study since they were informed of the experiment and participation was voluntary for the individuals,,Somewhat acceptable,"if they weren't debriefed or received consent, it seems a little bit unfair that they unknowingly participated in an experiment however, the amount of harm that it caused seems to be pretty low too, with it maybe causing some elevated emotional response to the post","if there was some kind of debriefing or consent asked, unless it was in the terms of agreements",Extremely important,Not at all important,Not at all important,Not at all important,Slightly important,Very important,Extremely important,Not at all important,Extremely important,whether or not what was performed was a normal feature of the website and could be done by regular individuals or not,7.0,4.0,6.0,3.0,2.0,5.0,1.0,,,,,,
424,True,1236.0,Facebook,34.0,Non-binary / third gender,Hispanic,Bachelor's degree,Very liberal,Not at all aware,"['… are large and can contain millions of data points', '… reflect events in real-time and can be collected continuously over time', '… often capture social relationships not found using traditional methods (e.g. surveys)']",['Secretly changing the content of what users see'],"['Communication (e.g. spread of opinions and hate-speech)', 'News consumption (e.g. sharing of misinformation)', 'Social networks']",3,-1,3,The researchers are made to abide by certain standards such as keeping participant identities anonymous and running an non-biased experiment.,Completely unacceptable,it seems unethical that the participants have not given consent to be part of the research,,Completely unacceptable,there should be some form of consent for the participants to be analyzed for the study,,Somewhat unacceptable,"for the amount of data and time participants are involved in the study, the payment is very low",,Completely unacceptable,"again, the participants should be made aware that their actions are being studied for academic purposes",,Moderately important,Not at all important,Not at all important,Slightly important,Not at all important,Moderately important,Extremely important,Not at all important,Moderately important,"in addition to a participant's consent, they should also know how their data will be used and if their data will be anonymous",6.0,1.0,4.0,2.0,3.0,7.0,5.0,researcher accountability--there should be a way participants can call for researchers to be held accountable for any abuse they may inflict on the participant or their data,3.0,,,,
425,True,770.0,Facebook,40.0,Male,White / Caucasian,Bachelor's degree,Neutral/ Neither conservative or liberal,Slightly aware,"['… are large and can contain millions of data points', '… reflect events in real-time and can be collected continuously over time', '… often capture social relationships not found using traditional methods (e.g. surveys)', '… are readily accessible to researchers and easy to collect']","['Privately messaging users', 'Creating fake accounts (""bots"")']","['Political elections (e.g. voting behavior)', 'Presidential approval ratings', 'Health topics (e.g. spread of diseases)', 'Public sentiment (e.g. environment-related concerns)', 'News consumption (e.g. sharing of misinformation)', 'Social networks']",2,2,6,I think ethical approval means obtaining approval from an oversight committee which is responsible for evaluating whether the methods are ethical. ,Somewhat acceptable,,,Somewhat unacceptable,,i am not a fan of the private messages,Neutral,,,Completely acceptable,,,Moderately important,Not at all important,Moderately important,Not at all important,Not at all important,Very important,Moderately important,Moderately important,Extremely important,,7.0,6.0,5.0,2.0,1.0,4.0,3.0,,1.0,,1.0,,1.0
426,True,1227.0,Reddit,27.0,Male,Hispanic,Bachelor's degree,Very conservative,Extremely aware,"['… are large and can contain millions of data points', '… reflect events in real-time and can be collected continuously over time', '… are naturalistic in that they do not require researchers to directly interact with research volunteers', '… often capture social relationships not found using traditional methods (e.g. surveys)', '… are readily accessible to researchers and easy to collect']","['Privately messaging users', ""Publicly posting on users' profiles"", 'Creating fake accounts (""bots"")']","['Political elections (e.g. voting behavior)', 'Presidential approval ratings', 'Health topics (e.g. spread of diseases)', 'Well-being and economic satisfaction', 'Communication (e.g. spread of opinions and hate-speech)', 'Public sentiment (e.g. environment-related concerns)', 'News consumption (e.g. sharing of misinformation)', 'Social networks']",3,3,8,Approval from a third-party that the research and the methods used being conducted are ethical.,Somewhat unacceptable,,,Somewhat acceptable,,,Completely unacceptable,,,Somewhat unacceptable,,,Extremely important,Not at all important,Very important,Not at all important,Moderately important,Extremely important,Extremely important,Slightly important,Extremely important,,7.0,2.0,4.0,1.0,3.0,5.0,6.0,,,,,,
427,True,1768.0,Facebook,46.0,Male,White / Caucasian,Associate's degree,Slightly conservative,Slightly aware,"['… are large and can contain millions of data points', '… reflect events in real-time and can be collected continuously over time', '… are naturalistic in that they do not require researchers to directly interact with research volunteers', '… often capture social relationships not found using traditional methods (e.g. surveys)', '… are readily accessible to researchers and easy to collect']","['Privately messaging users', 'Creating fake accounts (""bots"")']","['Political elections (e.g. voting behavior)', 'Economic forecasting', 'Presidential approval ratings', 'Well-being and economic satisfaction', 'Public sentiment (e.g. environment-related concerns)', 'News consumption (e.g. sharing of misinformation)']",3,2,6,I think that basically means an opt-in.,Completely unacceptable,people think they are engaging with independent people but secretly part of the study is unethical,if they exposed themselves afterward it might be different,Somewhat acceptable,,,Neutral,,,Somewhat unacceptable,i feel like the researchers have an agenda,fact-checkers often have a political agenda of their own,Extremely important,Very important,Very important,Very important,Very important,Moderately important,Very important,Moderately important,Extremely important,"no, pretty much the subjects must know that they were subjects in the end otherwise it was unethical",7.0,3.0,5.0,1.0,4.0,6.0,2.0,,,,,,
428,True,930.0,Twitter,44.0,Female,White / Caucasian,Bachelor's degree,Slightly liberal,Moderately aware,"['… are large and can contain millions of data points', '… reflect events in real-time and can be collected continuously over time', '… are naturalistic in that they do not require researchers to directly interact with research volunteers', '… often capture social relationships not found using traditional methods (e.g. surveys)', '… are readily accessible to researchers and easy to collect']","[""Publicly posting on users' profiles""]","['Political elections (e.g. voting behavior)', 'Public sentiment (e.g. environment-related concerns)', 'Social networks']",3,1,3,Ethical approval would mean that the institution finds it socially acceptable to run the experiments.,Completely acceptable,,,Neutral,,,Completely acceptable,,,Somewhat unacceptable,,,Slightly important,Not at all important,Not at all important,Very important,Very important,Moderately important,Moderately important,Moderately important,Slightly important,,7.0,6.0,4.0,2.0,1.0,5.0,3.0,,,,,,
429,True,2116.0,Facebook,59.0,Male,White / Caucasian,Bachelor's degree,Very liberal,Slightly aware,"['… are large and can contain millions of data points', '… often capture social relationships not found using traditional methods (e.g. surveys)', '… are readily accessible to researchers and easy to collect']","['Privately messaging users', ""Publicly posting on users' profiles""]","['Political elections (e.g. voting behavior)', 'Economic forecasting', 'Presidential approval ratings', 'Health topics (e.g. spread of diseases)', 'Well-being and economic satisfaction', 'Communication (e.g. spread of opinions and hate-speech)', 'Public sentiment (e.g. environment-related concerns)', 'News consumption (e.g. sharing of misinformation)', 'Social networks']",1,2,9,"It means approval that their research is being run without the use of unethical practices, meaning ones that can cause harm to research subjects or others. It also means the research is run free of bias. ",Completely unacceptable,participants were not aware they were part of a research study,,Completely unacceptable,participants were not aware they were part of a research study which makes this unthical,,Completely acceptable,,"if the web browser extension tracked anything other than news websites users visited with that browser or posts viewed in their facebook feeds such as typed passwords, personal emails, chat histories, that would be unethical",Completely unacceptable,participants were not aware they were part of a research study,,Not at all important,Moderately important,Not at all important,Not at all important,Not at all important,Slightly important,Extremely important,Not at all important,Slightly important,,6.0,2.0,5.0,4.0,1.0,7.0,3.0,,,,,,
430,True,2323.0,Reddit,37.0,Male,White / Caucasian,Bachelor's degree,Very liberal,Very aware,"['… are large and can contain millions of data points', '… reflect events in real-time and can be collected continuously over time', '… are naturalistic in that they do not require researchers to directly interact with research volunteers', '… often capture social relationships not found using traditional methods (e.g. surveys)', '… are readily accessible to researchers and easy to collect']","[""Publicly posting on users' profiles"", 'Secretly changing the content of what users see']","['Political elections (e.g. voting behavior)', 'Economic forecasting', 'Presidential approval ratings', 'Health topics (e.g. spread of diseases)', 'Well-being and economic satisfaction', 'Communication (e.g. spread of opinions and hate-speech)', 'Public sentiment (e.g. environment-related concerns)', 'News consumption (e.g. sharing of misinformation)', 'Social networks']",3,0,9,Ethical approval basically means that the researcher needs to ensure that their study is fair and causes no harm to the participant in anyway.,Somewhat acceptable,,,Neutral,,,Somewhat unacceptable,i feel the monetary reward may induce a lot of bias in this study,,Somewhat acceptable,,,Very important,Extremely important,Very important,Very important,Moderately important,Very important,Moderately important,Moderately important,Very important,,7.0,3.0,4.0,5.0,2.0,6.0,1.0,,,,,,
431,True,1134.0,Reddit,29.0,Male,White / Caucasian,Bachelor's degree,Very liberal,Extremely aware,"['… are large and can contain millions of data points', '… often capture social relationships not found using traditional methods (e.g. surveys)', '… are readily accessible to researchers and easy to collect']","['Creating fake accounts (""bots"")']","['Political elections (e.g. voting behavior)', 'Economic forecasting', 'Presidential approval ratings', 'Health topics (e.g. spread of diseases)', 'Well-being and economic satisfaction', 'Communication (e.g. spread of opinions and hate-speech)', 'Public sentiment (e.g. environment-related concerns)', 'News consumption (e.g. sharing of misinformation)', 'Social networks']",1,1,9,Ethical approval is following the ethical standards set forth by academic institutions in how the collect  maintain  and distribute data.,Completely acceptable,,i would like to know verbatim what they wrote,Somewhat unacceptable,i think private messages are a little unethical,verbatim what was sent in the messages,Completely unacceptable,even though they had to be granted access to the web browser extension i think that people wouldn't read the terms and conditions and it is invasive,how was data on the browser collected (ie metadata or raw data),Completely acceptable,i think this is a good way to go about doing this,i would like to know what fact checking sites were used,Very important,Moderately important,Very important,Moderately important,Slightly important,Extremely important,Extremely important,Very important,Extremely important,how the collected data is used and encrypted,6.0,1.0,5.0,4.0,3.0,7.0,2.0,,8.0,None,9.0,length of study and data collection,10.0
432,True,1865.0,Facebook,28.0,Female,White / Caucasian,Bachelor's degree,Slightly conservative,Moderately aware,"['… are large and can contain millions of data points', '… reflect events in real-time and can be collected continuously over time', '… are naturalistic in that they do not require researchers to directly interact with research volunteers']",['None of the above'],"['Political elections (e.g. voting behavior)', 'Economic forecasting', 'Presidential approval ratings', 'Health topics (e.g. spread of diseases)', 'Well-being and economic satisfaction', 'Communication (e.g. spread of opinions and hate-speech)', 'Public sentiment (e.g. environment-related concerns)', 'News consumption (e.g. sharing of misinformation)', 'Social networks']",3,0,9,"Ethical approval most likely means that the institution must check that a study is ethical. If the study is ethical then the institution will approve of the study. What I think ethnical means is that the study is not misleading, has misleading information, or is malicious. ",Somewhat unacceptable,"i feel like it's somewhat unacceptable because the people are unaware of they were part of a research study also, the fact that they created fake twitter accounts however, where i'm on the edge is that twitter is still a public site people are already aware that their information is not private",i feel like people should've become aware afterward and allowed to opt-out,Completely unacceptable,i don't like that they privately message people i always find direct messages uncomfortable if i don't know someone again i have a problem they were not aware they were part of a research study,,Completely acceptable,"my thoughts were that noting seems unacceptable i like that the people knew they were part of a study the pay was a little low, but people were aware of the pay",,Somewhat unacceptable,i still have an issue that the people are unaware they are part of the research,i feel like if they were aware of the study afterward or could opt out then it would be acceptable,Moderately important,Not at all important,Slightly important,Slightly important,Slightly important,Very important,Extremely important,Slightly important,Moderately important,i don't believe i had any concerts that determine my level of concern i feel like what's listed expressed any concerns that i had concerning prior questions,7.0,1.0,4.0,2.0,3.0,6.0,5.0,"without someone's approval, researchers shouldn't send private messages or post on people's social media",8.0,,,,
433,True,830.0,Facebook,40.0,Male,White / Caucasian,Highschool,Very liberal,Extremely aware,"['… are large and can contain millions of data points', '… reflect events in real-time and can be collected continuously over time', '… often capture social relationships not found using traditional methods (e.g. surveys)', '… are readily accessible to researchers and easy to collect']","['Privately messaging users', ""Publicly posting on users' profiles""]","['Political elections (e.g. voting behavior)', 'Economic forecasting', 'Presidential approval ratings', 'Health topics (e.g. spread of diseases)', 'Well-being and economic satisfaction', 'Communication (e.g. spread of opinions and hate-speech)', 'Public sentiment (e.g. environment-related concerns)', 'News consumption (e.g. sharing of misinformation)', 'Social networks']",2,2,9,"It means that the study is done in a way that respects the rights and well being of the research participants. In addition, the study is performed without manipulation or bias (unless those tactics are clearly stated in the research as part of the experiment). The studies follow all laws and regulations.",Completely acceptable,"again, anyone is allowed to respond to a public tweet","again, only if private tweets were accessed or other accounts were accessed without consent would it be unethical",Completely acceptable,"again, anyone is allowed to private message another user, so no rules were broken","if the responses to these private messages were saved and shared, that would be a violation of privacy, but that was not stated in the reading",Completely acceptable,"if the participants consented to the study, it's ethical","if the participants did not receive the stated compensation, or if other data not specified in the consent form was accessed, that would be unethical",Completely acceptable,"since anyone can post on twitter and interact with other users, it doesn't break any rules ideally, in all situations, experiment participants would give their consent, but in this case, no rules or laws were broken, and it allowed researchers to gain unbiased results (ie, if the participants knew they were part of the experiment, they might change their behavior over how they would normally act)",only if the researchers collected data that was not publicly available (such as private tweets or accessing other users' accounts) would it be unethical,Extremely important,Not at all important,Moderately important,Not at all important,Moderately important,Moderately important,Moderately important,Not at all important,Extremely important,,7.0,3.0,5.0,4.0,2.0,6.0,1.0,"respect and protect privacy if data is private (if a post or tweet is from a private account, or if a users private messages are used, they must be informed)",4.0,,,,
434,True,1429.0,Reddit,41.0,Male,Mixed race,Highschool,Slightly liberal,Not at all aware,"['… are large and can contain millions of data points', '… reflect events in real-time and can be collected continuously over time', '… are naturalistic in that they do not require researchers to directly interact with research volunteers', '… often capture social relationships not found using traditional methods (e.g. surveys)', '… are readily accessible to researchers and easy to collect']","['Creating fake accounts (""bots"")', 'Secretly changing the content of what users see']","['Political elections (e.g. voting behavior)', 'Presidential approval ratings', 'Health topics (e.g. spread of diseases)', 'Well-being and economic satisfaction', 'Public sentiment (e.g. environment-related concerns)', 'News consumption (e.g. sharing of misinformation)']",3,0,6,"I have no idea what ethical approval means. I understand what ethical is, but I don't know whose approval it is that they need.",Somewhat unacceptable,,,Somewhat unacceptable,i just find it unethical in general to study people without them knowing,sending private messages is kind of creepy,Somewhat acceptable,,"they volunteered for the study, so of course it's more acceptable",Somewhat unacceptable,i don't trust the scientist to know the truth many times i've made an innocuous comment that was taken as toxic on social media there's no way for you to know for sure,making a bot account that pretends to be human is also inherently unethical,Not at all important,Not at all important,Not at all important,Not at all important,Slightly important,Very important,Extremely important,Not at all important,Moderately important,"the phrase the end justifies the means comes to mind you can't trick people, but because the outcome was supposedly less hate speech or whatever decide that it's ok to trick people",7.0,2.0,5.0,4.0,1.0,6.0,3.0,,,,,,
435,True,759.0,Reddit,34.0,Female,White / Caucasian,Master's degree or above,Very liberal,Very aware,"['… are large and can contain millions of data points', '… reflect events in real-time and can be collected continuously over time', '… are naturalistic in that they do not require researchers to directly interact with research volunteers', '… are readily accessible to researchers and easy to collect']","['Creating fake accounts (""bots"")', 'Secretly changing the content of what users see']","['Well-being and economic satisfaction', 'Communication (e.g. spread of opinions and hate-speech)', 'Public sentiment (e.g. environment-related concerns)', 'News consumption (e.g. sharing of misinformation)', 'Social networks']",2,0,5,Ethical approval means that they're not doing harm to anyone participating in the experiment.,Somewhat acceptable,"the nonconsentnotification of the experiment is a slight issue, but i can see how that would compromise the experiment no harm was done by not notifying the participant since it was a one off message they were sent",,Neutral,the unsolicited private message feels uncomfortable particularly since participants weren't notified about the study,,Somewhat acceptable,browser extensions always make me a bit nervous about security risks but other than that the study sounds all right since people were informed and consented to the experiment,,Completely acceptable,,,Very important,Not at all important,Very important,Slightly important,Moderately important,Extremely important,Very important,Slightly important,Moderately important,,7.0,2.0,1.0,4.0,5.0,3.0,6.0,,,,,,
436,True,1611.0,Facebook,52.0,Female,White / Caucasian,Bachelor's degree,Slightly liberal,Slightly aware,"['… are large and can contain millions of data points', '… reflect events in real-time and can be collected continuously over time', '… are naturalistic in that they do not require researchers to directly interact with research volunteers', '… are readily accessible to researchers and easy to collect']","['Creating fake accounts (""bots"")']","['Political elections (e.g. voting behavior)', 'Economic forecasting', 'Health topics (e.g. spread of diseases)', 'Well-being and economic satisfaction', 'Communication (e.g. spread of opinions and hate-speech)', 'Public sentiment (e.g. environment-related concerns)', 'News consumption (e.g. sharing of misinformation)']",2,1,7,It means making sure that everything they are doing is fine from an ethical standpoint. ,Completely acceptable,,,Somewhat acceptable,,,Somewhat acceptable,,,Somewhat unacceptable,,,Very important,Very important,Very important,Very important,Moderately important,Moderately important,Moderately important,Very important,Very important,,2.0,3.0,5.0,4.0,1.0,7.0,6.0,,1.0,None,2.0,,3.0
437,True,2465.0,Facebook,43.0,Female,White / Caucasian,Bachelor's degree,Slightly liberal,Moderately aware,"['… are large and can contain millions of data points', '… reflect events in real-time and can be collected continuously over time', '… are naturalistic in that they do not require researchers to directly interact with research volunteers', '… often capture social relationships not found using traditional methods (e.g. surveys)', '… are readily accessible to researchers and easy to collect']","['Privately messaging users', 'Creating fake accounts (""bots"")']","['Well-being and economic satisfaction', 'Communication (e.g. spread of opinions and hate-speech)', 'Public sentiment (e.g. environment-related concerns)', 'News consumption (e.g. sharing of misinformation)', 'Social networks']",3,2,5,"I think ""ethical approval"" means that the Institutional Review Board has reviewed the proposed purpose and methods of the research and determined that there is little risk of significant harm to research participants. ",Completely unacceptable,i am concerned that participants were included in the study without their consent especially considering that their public twitter behavior was analyzed for a significant length of time,,Completely unacceptable,"i am concerned that users were included in the research without their consent, given that they received unsolicited message via anonymous accounts and had their data analyzed i also think that there may be some questionable ethics related to including only conservatives in the study as this could potential result in skewed andor biased results",i would be interested to know whether the researchers made it clear (in their study results) that they were targeting conservative users since failing to do so could result in biased conclusions (which i think is an important ethical consideration in research),Somewhat acceptable,"i have some minor concerns regarding the ethics of this study i think the study is somewhat ethically acceptable because participants gave consent to participate in the study however, my concern is that the recruitment process for seeing the study advertisement was a targeted ad, meaning it was based on facebook algorithms which use user data to generate targeted newsad feeds i think this could be a minor privacy violation since users did not give their consent for the researchers to use their facebook data prior to receiving the targeted ad i also think the participants should be entitled to receive a copy of the study results without being required to forfeit their study compensation",i am not sure of facebook's data collection process for targeted ads so having more information about how people were targeted for the study might influence my perceptions of the study,Completely unacceptable,"i am concerned that twitter users were included in the study without their consent, especially considering that the researchers used automated, human-looking accounts to mislead the users into thinking that they had received information from a real person",,Moderately important,Slightly important,Very important,Moderately important,Moderately important,Moderately important,Extremely important,Very important,Moderately important,"i am concerned that researchers may be using data from social media to determine target participants for their study (such as facebook ad algorithms) to my knowledge, having ones data collected or analyzed by outside researchers is not included in the user terms of service or consents so even this preliminary data analysis may be inappropriate from a research ethics perspective",6.0,1.0,5.0,2.0,7.0,4.0,3.0,transparency regarding how participants are includedchosen for the research to decrease potential bias in research data and decrease potential for improper application of research findings (this may be related to scientific reproducibility),6.0,,,,
438,True,1049.0,Facebook,35.0,Male,White / Caucasian,Bachelor's degree,Slightly conservative,Moderately aware,"['… are large and can contain millions of data points', '… reflect events in real-time and can be collected continuously over time', '… are naturalistic in that they do not require researchers to directly interact with research volunteers', '… are readily accessible to researchers and easy to collect']","['Privately messaging users', ""Publicly posting on users' profiles""]","['Political elections (e.g. voting behavior)', 'Economic forecasting', 'Presidential approval ratings', 'Health topics (e.g. spread of diseases)', 'Well-being and economic satisfaction', 'Communication (e.g. spread of opinions and hate-speech)', 'Public sentiment (e.g. environment-related concerns)', 'News consumption (e.g. sharing of misinformation)', 'Social networks']",2,2,9,"That the scope, intent, data gathering goal, and methods used (material, etc) are ethical. This allows the institution to ensure it is up to the standards before allowing researchers to collect the information.",Completely acceptable,,,Completely acceptable,,,Completely acceptable,,,Somewhat acceptable,"tweets are public so should be known that that info is being viewed, shared, studied etc",,Moderately important,Slightly important,Very important,Very important,Slightly important,Very important,Very important,Very important,Very important,,7.0,5.0,3.0,2.0,1.0,4.0,6.0,,8.0,,9.0,,10.0
439,True,598.0,Facebook,31.0,Male,White / Caucasian,Master's degree or above,Slightly conservative,Moderately aware,['… are readily accessible to researchers and easy to collect'],['Privately messaging users'],"['Political elections (e.g. voting behavior)', 'Economic forecasting', 'Presidential approval ratings', 'Health topics (e.g. spread of diseases)', 'Well-being and economic satisfaction', 'Communication (e.g. spread of opinions and hate-speech)', 'Public sentiment (e.g. environment-related concerns)', 'News consumption (e.g. sharing of misinformation)', 'Social networks']",-1,1,9,The IRB needs to determine if the nature of their experiment holds an ethical standard in what it is trying to achieve and that it doesn't hurt or violate the rights of individuals who are participating.,Completely unacceptable,it seems unethical if they didn't know they were part of the research study,it seems unethical if they didn't know they were part of the research study,Completely acceptable,this seems pretty ethical and a good use of social media to conduct an experiment,,Completely acceptable,"i felt the reward was a little low, but definitely ethical","i felt the reward was a little low, but definitely ethical",Completely unacceptable,participants should be aware they are part of the experiment in some way this seems quite unethical,participants should be aware they are part of the experiment in some way this seems quite unethical,Extremely important,Extremely important,Extremely important,Extremely important,Extremely important,Extremely important,Extremely important,Extremely important,Extremely important,the concern is more so in the agenda behind the data and how the results are framed after the fact,5.0,2.0,7.0,4.0,1.0,3.0,6.0,,,,,,
440,True,912.0,Facebook,47.0,Female,White / Caucasian,Associate's degree,Slightly conservative,Very aware,"['… reflect events in real-time and can be collected continuously over time', '… are naturalistic in that they do not require researchers to directly interact with research volunteers', '… often capture social relationships not found using traditional methods (e.g. surveys)', '… are readily accessible to researchers and easy to collect']",['Privately messaging users'],"['Political elections (e.g. voting behavior)', 'Communication (e.g. spread of opinions and hate-speech)', 'News consumption (e.g. sharing of misinformation)']",2,1,3,I would assume they seek approval before continuing with a project as well as getting approval from those individuals for their data.,Neutral,,,Somewhat acceptable,,,Completely acceptable,,,Neutral,,,Very important,Extremely important,Moderately important,Moderately important,Moderately important,Moderately important,Very important,Moderately important,Very important,it is hard to say that it is ethical not to tell the public they are studying its content,7.0,1.0,6.0,4.0,2.0,3.0,5.0,,,,,,
441,True,817.0,Facebook,47.0,Male,White / Caucasian,Highschool,Very liberal,Extremely aware,"['… are large and can contain millions of data points', '… reflect events in real-time and can be collected continuously over time', '… are naturalistic in that they do not require researchers to directly interact with research volunteers', '… often capture social relationships not found using traditional methods (e.g. surveys)', '… are readily accessible to researchers and easy to collect']","['Creating fake accounts (""bots"")', 'Secretly changing the content of what users see']","['Health topics (e.g. spread of diseases)', 'Communication (e.g. spread of opinions and hate-speech)', 'Public sentiment (e.g. environment-related concerns)', 'News consumption (e.g. sharing of misinformation)']",3,0,4,"I would assume that they have to prove that the experiment poses no risk to the emotional, physical, or mental health of anyone participating. (Or to get explicit permission if such risks exist.) There's probably also some level of consideration to whether or not discovery of, or the operation of such an experiment could cause widespread societal effects. (Which might be under the emotional/mental health umbrella.)",Completely acceptable,"i would like to see the parameters of what was considered ""hate speech""",,Somewhat acceptable,"my only issue is with the direct communication without informing the people about the purpose that feels unethical i understand why they might not wish to reveal the purpose beforehand (risk of biasing data), but i'm not sure that it's ethical to do soone could also argue that by specifically targeting conservatives solely, they don't have a good baseline for default behavior overall, and there's limited value in the study i would be a little concerned that they're working backward and trying to make the data fit whatever hypothesis they have","i would be very interested to know if the researchers identify as liberalprogressive, and i would like to know if the study was being specifically created by andor funded by a particular organization or think tank",Completely acceptable,,,Completely acceptable,,,Moderately important,Extremely important,Very important,Slightly important,Not at all important,Very important,Extremely important,Not at all important,Slightly important,"how long data is stored, and if personally identifiable information is obscuredremoved",3.0,5.0,7.0,4.0,1.0,6.0,2.0,,,,,,
442,True,827.0,Reddit,61.0,Female,White / Caucasian,Bachelor's degree,Slightly conservative,Slightly aware,"['… are large and can contain millions of data points', '… reflect events in real-time and can be collected continuously over time', '… are naturalistic in that they do not require researchers to directly interact with research volunteers', '… often capture social relationships not found using traditional methods (e.g. surveys)', '… are readily accessible to researchers and easy to collect']",['None of the above'],"['Health topics (e.g. spread of diseases)', 'Communication (e.g. spread of opinions and hate-speech)', 'Public sentiment (e.g. environment-related concerns)', 'News consumption (e.g. sharing of misinformation)', 'Social networks']",3,0,5,researchers must write a narrative of their experiment and methodology and have it reviewed and approved by the IRB,Somewhat acceptable,,,Somewhat acceptable,,,Completely acceptable,,,Somewhat acceptable,,,Not at all important,Slightly important,Not at all important,Moderately important,Not at all important,Slightly important,Not at all important,Slightly important,Not at all important,"by level of concern my ratings are primarily associated with quality of the study and not ethics if people are publicly posting, they have no right to expect privacy of that content it is there for the world to see and if they are influenced by research being conducted, they are making themselves vulnerable to it through their behavior",4.0,6.0,7.0,3.0,5.0,2.0,1.0,,,,,,
443,True,1365.0,Reddit,23.0,Non-binary / third gender,White / Caucasian,Bachelor's degree,Very liberal,Extremely aware,"['… are large and can contain millions of data points', '… reflect events in real-time and can be collected continuously over time', '… are naturalistic in that they do not require researchers to directly interact with research volunteers', '… often capture social relationships not found using traditional methods (e.g. surveys)']","['Privately messaging users', ""Publicly posting on users' profiles"", 'Creating fake accounts (""bots"")']","['Political elections (e.g. voting behavior)', 'Economic forecasting', 'Presidential approval ratings', 'Health topics (e.g. spread of diseases)', 'Well-being and economic satisfaction', 'Communication (e.g. spread of opinions and hate-speech)', 'Public sentiment (e.g. environment-related concerns)', 'News consumption (e.g. sharing of misinformation)', 'Social networks']",4,3,9,Ethical approval refers to recognizing that a researcher's proposed research methods are ethically sound and won't harm others irreversibly and approves them to move forward with their desired research.,Completely acceptable,seems like a well-designed study i do wonder if there were any negative replies that the researchers committed to that enhanced hate speech or not the brief summary of the study doesn't mention that they didn't find any other statistically significant effects,,Completely acceptable,interesting and simple way to promote mindfulness that allows people to monitor and self correct their own behaviour,,Somewhat acceptable,"advertising typically strikes me as unethical in general, but beyond that, the study seems ethically sound",,Somewhat acceptable,"while i feel as if the study is ethically acceptable, i feel as if there is some ethical concerns for how it may affect society on a whole in particular, further polarization of individuals is not a desirable result and it is well known that strong cognitive dissonance makes individuals engage more in confirmation bias related behaviours",whether or not the human-looking bot accounts were bought off from existing and real users and then converted to bots with their profile still intact,Not at all important,Not at all important,Moderately important,Not at all important,Slightly important,Slightly important,Slightly important,Moderately important,Slightly important,disclosure is typically considered pretty important in research and its difficult to examine and manipulate individuals without their awareness and then disclose to them that they were examined after the fact,7.0,6.0,5.0,1.0,3.0,2.0,4.0,None,4.0,,,,
444,True,1799.0,Facebook,55.0,Male,White / Caucasian,Highschool,Slightly liberal,Not at all aware,"['… are large and can contain millions of data points', '… are naturalistic in that they do not require researchers to directly interact with research volunteers', '… often capture social relationships not found using traditional methods (e.g. surveys)', '… are readily accessible to researchers and easy to collect']","['Privately messaging users', ""Publicly posting on users' profiles"", 'Creating fake accounts (""bots"")']","['Political elections (e.g. voting behavior)', 'Health topics (e.g. spread of diseases)', 'Communication (e.g. spread of opinions and hate-speech)', 'Public sentiment (e.g. environment-related concerns)', 'News consumption (e.g. sharing of misinformation)', 'Social networks']",2,3,6,"gosh is there even such a thing? I find this rather disturbing and after this survey is over I will be research for more information on this because to be honest this is VERY unethical. But for the sake of responding to this question I will say that ethical approval means the institution decides how far the researchers can go into peoples private lives and invade their privacy and trample on peoples rights. Its a mix between what they need, and the excuses the institutions will make to themselves in order to do this. Kind of like walking right into someones house, but your invisible and you have to decide where to draw the line - can I steal food? no.. can I watch them having sex? yes.. its a question of approving what they want and need and lying to themselves to say its ok to do so. ",Completely unacceptable,if this is true? i am sickened by it and stunned and have nothing more to say this is beyond immoral and unethical typical of universities,,Completely unacceptable,"i just don't believe its proper to do research and not inform the person of such you can collect data, or scan postings but to interact with people under false pretense? shameless","i think the researchers should be fined very heavily, and perhaps a few months in jail for violating peoples rights would help them a bit as well",Completely acceptable,the key work here was 'informed' that is what makes it ethical and acceptable,"as i said above, the fact that they were willing participants makes all the difference between ethical and unethical",Completely unacceptable,lab rats without consent - how pleasant this all is,,Very important,Moderately important,Not at all important,Moderately important,Very important,Extremely important,Extremely important,Very important,Slightly important,its simple consent must be given any thing else is criminal and should be stopped immediately so immoral and unethical but again this is what we have seen from universitys for decades- ethics and morality are not words they understand,6.0,1.0,5.0,2.0,4.0,7.0,3.0,,1.0,None,2.0,None,3.0
445,True,1310.0,Facebook,47.0,Female,White / Caucasian,Highschool,Very liberal,Moderately aware,"['… reflect events in real-time and can be collected continuously over time', '… are naturalistic in that they do not require researchers to directly interact with research volunteers', '… often capture social relationships not found using traditional methods (e.g. surveys)', '… are readily accessible to researchers and easy to collect']",['Secretly changing the content of what users see'],"['Political elections (e.g. voting behavior)', 'Economic forecasting', 'Presidential approval ratings', 'Health topics (e.g. spread of diseases)', 'Well-being and economic satisfaction', 'Communication (e.g. spread of opinions and hate-speech)', 'Public sentiment (e.g. environment-related concerns)', 'News consumption (e.g. sharing of misinformation)', 'Social networks']",2,-1,9,Their peers feel their project is genuine and has a clear purpose in what they are doing.,Completely acceptable,,,Somewhat acceptable,"this is good, misinformation is a big problem",,Completely acceptable,"these researchers are doing good work, maybe this is a solution to help a divided country",,Completely acceptable,,,Moderately important,Very important,Moderately important,Moderately important,Moderately important,Very important,Extremely important,Very important,Moderately important,"i guess people spread misinformation without thinking this is good and interesting research and it's these people who concern me, not the methods of research",6.0,7.0,2.0,5.0,3.0,4.0,1.0,use several groups of participants,5.0,,,,
446,True,875.0,Facebook,32.0,Female,Other,Master's degree or above,Neutral/ Neither conservative or liberal,Slightly aware,['… are readily accessible to researchers and easy to collect'],"['Creating fake accounts (""bots"")']",['News consumption (e.g. sharing of misinformation)'],-1,1,1,"I have no clue, there seems to be little ethics involved these days. But maybe it's supposed to stop researchers from hacking accounts and misusing the info they get.",Completely unacceptable,,,Completely unacceptable,,,Somewhat acceptable,,,Completely unacceptable,,,Extremely important,Slightly important,Very important,Moderately important,Moderately important,Very important,Extremely important,Slightly important,Slightly important,,7.0,3.0,5.0,2.0,1.0,6.0,4.0,,1.0,,,,
447,True,977.0,Twitter,34.0,Female,African-American,Bachelor's degree,Slightly liberal,Extremely aware,"['… often capture social relationships not found using traditional methods (e.g. surveys)', '… are readily accessible to researchers and easy to collect', '… are always representative of people’s offline behavior']","['Privately messaging users', ""Publicly posting on users' profiles"", 'Creating fake accounts (""bots"")', 'Secretly changing the content of what users see']","['Political elections (e.g. voting behavior)', 'Economic forecasting', 'Well-being and economic satisfaction', 'Communication (e.g. spread of opinions and hate-speech)', 'Public sentiment (e.g. environment-related concerns)', 'News consumption (e.g. sharing of misinformation)']",-1,2,6,Ethical approval protects both the researcher and the participants during a research process.,Completely acceptable,,,Completely acceptable,,,Completely acceptable,,,Completely acceptable,,,Extremely important,Very important,Extremely important,Extremely important,Very important,Extremely important,Extremely important,Extremely important,Extremely important,,6.0,1.0,4.0,2.0,3.0,5.0,7.0,,,,,,
448,True,1027.0,Facebook,45.0,Female,White / Caucasian,Highschool,Slightly conservative,Moderately aware,"['… are large and can contain millions of data points', '… reflect events in real-time and can be collected continuously over time', '… are naturalistic in that they do not require researchers to directly interact with research volunteers', '… often capture social relationships not found using traditional methods (e.g. surveys)', '… are readily accessible to researchers and easy to collect', '… are always representative of people’s offline behavior', '… are unaffected by the way social media platforms work', '… are well formatted and never contain any missing data']",['None of the above'],"['Political elections (e.g. voting behavior)', 'Economic forecasting', 'Presidential approval ratings', 'Health topics (e.g. spread of diseases)', 'Communication (e.g. spread of opinions and hate-speech)', 'News consumption (e.g. sharing of misinformation)']",0,0,6,approval from the person your getting the information from to see if it is ok to use their information,Somewhat acceptable,,,Somewhat acceptable,,,Somewhat acceptable,,,Somewhat acceptable,,,Moderately important,Very important,Moderately important,Very important,Slightly important,Moderately important,Very important,Moderately important,Slightly important,,7.0,1.0,6.0,2.0,4.0,5.0,3.0,,,,,,
449,True,1108.0,Reddit,56.0,Female,White / Caucasian,Bachelor's degree,Very liberal,Moderately aware,"['… are large and can contain millions of data points', '… often capture social relationships not found using traditional methods (e.g. surveys)']","['Privately messaging users', 'Creating fake accounts (""bots"")', 'Secretly changing the content of what users see']","['Political elections (e.g. voting behavior)', 'Presidential approval ratings', 'Health topics (e.g. spread of diseases)', 'Well-being and economic satisfaction', 'Communication (e.g. spread of opinions and hate-speech)', 'Public sentiment (e.g. environment-related concerns)', 'News consumption (e.g. sharing of misinformation)', 'Social networks']",2,1,8,Ethical approval means the methods for the study have been reviewed to make sure they comply with the standards for research and aren’t using questionable means to obtain data.,Completely acceptable,i’d still wonder about trolls and bots but the behavior changes observed seem to indicate actual people behind the accounts i wonder about how they get demographics for the participants,,Completely acceptable,"as with the others, i’d be concerned that the twitter accounts are bot or troll accounts but then results of the study indicated that they were able to track a change in behavior after the direct message",,Completely acceptable,i would be concerned about fake accounts but everything else seems ethical,,Completely acceptable,"i’d be concerned that researchers were responding to and reviewing tweets for troll or bot accounts, or from subversive actors, and not getting valid data",,Extremely important,Extremely important,Extremely important,Very important,Extremely important,Very important,Not at all important,Extremely important,Extremely important,,1.0,7.0,3.0,6.0,2.0,5.0,4.0,that they’re not reviewing fake accounts and the data comes from actual people,1.0,,,,
450,True,1227.0,Reddit,35.0,Female,White / Caucasian,Highschool,Very liberal,Slightly aware,"['… reflect events in real-time and can be collected continuously over time', '… are naturalistic in that they do not require researchers to directly interact with research volunteers', '… often capture social relationships not found using traditional methods (e.g. surveys)', '… are readily accessible to researchers and easy to collect']","['Creating fake accounts (""bots"")']","['Political elections (e.g. voting behavior)', 'Economic forecasting', 'Presidential approval ratings', 'Health topics (e.g. spread of diseases)', 'Well-being and economic satisfaction', 'Communication (e.g. spread of opinions and hate-speech)', 'Public sentiment (e.g. environment-related concerns)', 'News consumption (e.g. sharing of misinformation)']",2,1,8,If researchers get ethical approval for their study then the study was deemed morally acceptable.,Completely acceptable,,,Completely acceptable,,,Somewhat acceptable,"i don't like the idea of targeted advertisement, but understand that it's a widely used tactic and is accepted by most people installing the extension seems really invasive, but taking part in the study was optional, so it leaves the decision of whether or not to install it completely up to the user",,Neutral,"the usage of bots always leaves extra room for error having the bot say ""might"" not be true is great, and having the bot provide a fact-checking tool is great just because the results of the study had a negative effect, does not mean it was a bad or unacceptable study",,Very important,Extremely important,Extremely important,Very important,Extremely important,Extremely important,Not at all important,Moderately important,Extremely important,"no, i think all of the points were covered here that i could think of",6.0,7.0,3.0,2.0,1.0,5.0,4.0,whether or not the researchers will let the 'participant' know afterwards that they were part of a study (ie debriefing),8.0,,,,
451,True,3014.0,Facebook,48.0,Female,White / Caucasian,Bachelor's degree,Slightly conservative,Not at all aware,"['… are large and can contain millions of data points', '… are naturalistic in that they do not require researchers to directly interact with research volunteers', '… often capture social relationships not found using traditional methods (e.g. surveys)', '… are readily accessible to researchers and easy to collect']","['Creating fake accounts (""bots"")', 'Secretly changing the content of what users see']","['Communication (e.g. spread of opinions and hate-speech)', 'Public sentiment (e.g. environment-related concerns)', 'News consumption (e.g. sharing of misinformation)']",2,0,3,By reviewing the methods of the research to ensure it’s ethical.,Completely unacceptable,i think many factors could of changed the reasons for people posting less hate speechi don’t agree with someone being used in a study unless they are aware and agree to be part of a study,,Completely unacceptable,my concern is why the study only used right leaning posts and the use of fact checkers who have been shown to claim facts are untrue when they are true,,Completely acceptable,i find the study to be acceptable as the participants knew and chose to be part of the study,,Completely unacceptable,when using someone in a study and they are not aware they are part of a study and using a false account to state facts might be untrue (and we know fact checkers aren’t always correct) can skew the outcome of the study,,Extremely important,Extremely important,Not at all important,Extremely important,Not at all important,Very important,Extremely important,Moderately important,Extremely important,when there is use of fact checkers as we have found out from facebook blocking users for false information when later it was found to be true,7.0,1.0,2.0,4.0,3.0,6.0,5.0,,,,,,
452,True,1052.0,Facebook,55.0,Female,White / Caucasian,Bachelor's degree,Slightly liberal,Slightly aware,"['… are large and can contain millions of data points', '… are naturalistic in that they do not require researchers to directly interact with research volunteers', '… are readily accessible to researchers and easy to collect']","['Creating fake accounts (""bots"")']","['Political elections (e.g. voting behavior)', 'Communication (e.g. spread of opinions and hate-speech)', 'Public sentiment (e.g. environment-related concerns)', 'News consumption (e.g. sharing of misinformation)', 'Social networks']",1,1,5,Institutional review boards determine whether studies and/or experiments meet certain established ethical standards and guidelines for research.,Completely acceptable,,"as long as researchers were attempting to defuse the hate speech, it's fine if they had instead been trying to see what results of amplifying or encouraging hate speech were, it would not be ethically acceptable",Completely acceptable,presumably only those users who actually responded to private msg asking them to rate headline were included; dr facto they were more likely to be thoughtful and responsive than those users who did not comply with request,,Completely acceptable,participants were fully informed and opted in to study they were not duped in any way,,Completely acceptable,,,Not at all important,Extremely important,Very important,Slightly important,Slightly important,Moderately important,Slightly important,Slightly important,Not at all important,,2.0,4.0,7.0,6.0,3.0,5.0,1.0,,,,,,
453,True,1064.0,Reddit,44.0,Male,White / Caucasian,Master's degree or above,Very liberal,Moderately aware,"['… are large and can contain millions of data points', '… reflect events in real-time and can be collected continuously over time', '… are readily accessible to researchers and easy to collect']",['Privately messaging users'],"['Presidential approval ratings', 'Health topics (e.g. spread of diseases)', 'Communication (e.g. spread of opinions and hate-speech)', 'Public sentiment (e.g. environment-related concerns)', 'Social networks']",1,1,5,"No idea how universities may spin the word. Ethical is if something I'd morally correct or not, so I suppose ""ethical approval"" may be passing a check to ensure that the experiment isn't harmful to anyone. ",Neutral,i suppose the fact that they weren't aware they were a part of the study may be considered somewhat unethical,,Neutral,"same concern as the previous i'm not sure if it's ethically acceptable to study people without them knowing is it? i would see no problem with it myself, but i'm trying to look at where organizations may want to be extra careful",,Neutral,,,Completely acceptable,"an interesting study, but a somewhat predictable result when faced with any kind of argumentative interaction (and a bot simply pointing out that what was posted may be incorrect would be perceived as argumentative) people tend to retreat even further into their beliefs",,Moderately important,Slightly important,Moderately important,Slightly important,Not at all important,Slightly important,Moderately important,Slightly important,Slightly important,,2.0,7.0,3.0,6.0,1.0,5.0,4.0,,10.0,,10.0,,10.0
454,True,3241.0,Twitter,39.0,Male,White / Caucasian,Master's degree or above,Neutral/ Neither conservative or liberal,Very aware,"['… reflect events in real-time and can be collected continuously over time', '… are naturalistic in that they do not require researchers to directly interact with research volunteers', '… often capture social relationships not found using traditional methods (e.g. surveys)']","['Privately messaging users', ""Publicly posting on users' profiles"", 'Creating fake accounts (""bots"")']","['Political elections (e.g. voting behavior)', 'Well-being and economic satisfaction', 'Public sentiment (e.g. environment-related concerns)', 'News consumption (e.g. sharing of misinformation)']",3,3,4,Ensuring that the study isn't a human rights violation or otherwise unethical.,Completely acceptable,,,Completely acceptable,,,Completely acceptable,,,Completely acceptable,"they meant well, but it made things worse still, they needed to know how people would react",,Very important,Extremely important,Extremely important,Very important,Extremely important,Slightly important,Extremely important,Extremely important,Extremely important,,5.0,6.0,7.0,2.0,1.0,3.0,4.0,,,,,,
455,True,1941.0,Facebook,34.0,Female,Asian - Eastern,Bachelor's degree,Neutral/ Neither conservative or liberal,Slightly aware,['… are large and can contain millions of data points'],"['Privately messaging users', ""Publicly posting on users' profiles""]","['Economic forecasting', 'Presidential approval ratings', 'Communication (e.g. spread of opinions and hate-speech)', 'News consumption (e.g. sharing of misinformation)']",1,2,4,That it is signed off and the actions they do are vetted,Somewhat acceptable,this does look at real posts and not informing the intent is the only way to get real posts,,Neutral,i think it does create a fail safe check,,Somewhat unacceptable,the enticement of gifts seems to counteract the thought of real research,,Neutral,,,Very important,Very important,Very important,Very important,Moderately important,Very important,Slightly important,Extremely important,Moderately important,,5.0,3.0,1.0,7.0,2.0,6.0,4.0,,,,,,
456,True,1654.0,Twitter,26.0,Non-binary / third gender,White / Caucasian,Highschool,Neutral/ Neither conservative or liberal,Extremely aware,"['… often capture social relationships not found using traditional methods (e.g. surveys)', '… are readily accessible to researchers and easy to collect']","['Creating fake accounts (""bots"")', 'Secretly changing the content of what users see']","['Political elections (e.g. voting behavior)', 'Presidential approval ratings', 'News consumption (e.g. sharing of misinformation)', 'Social networks']",0,0,4,Ethical approval basically mean that they have to comply with a set standard ethically in order to run their experiments.  Meaning that they are friendly to people that are not as damaged by the world.,Neutral,,,Somewhat unacceptable,"i still think that it is not the best to construed scientific data, but in some cases that is what happens",,Neutral,,,Somewhat unacceptable,"it's a bit like some scientific studies, sometimes people end up fudging data on purpose to make things look the way they want",,Very important,Moderately important,Very important,Very important,Very important,Very important,Very important,Very important,Extremely important,,3.0,2.0,7.0,1.0,6.0,4.0,5.0,,,,,,
457,True,1127.0,Facebook,34.0,Female,White / Caucasian,Bachelor's degree,Slightly liberal,Moderately aware,"['… reflect events in real-time and can be collected continuously over time', '… are naturalistic in that they do not require researchers to directly interact with research volunteers', '… often capture social relationships not found using traditional methods (e.g. surveys)', '… are readily accessible to researchers and easy to collect']","['Privately messaging users', ""Publicly posting on users' profiles""]","['Public sentiment (e.g. environment-related concerns)', 'News consumption (e.g. sharing of misinformation)', 'Social networks']",2,2,3,It means it has been approved by an ethical board at their institution agreeing that their study follows ethical guidelines. ,Completely unacceptable,they didn't inform their participant pool,,Completely acceptable,,,Somewhat acceptable,they didn't offer appropriate compensation,,Completely unacceptable,they didn't inform people they were in a study and their tweets could have caused harm,,Moderately important,Moderately important,Moderately important,Very important,Moderately important,Very important,Extremely important,Extremely important,Moderately important,,5.0,1.0,6.0,2.0,4.0,7.0,3.0,,,,,,
458,True,1016.0,Facebook,26.0,Male,White / Caucasian,Bachelor's degree,Slightly liberal,Not at all aware,"['… are naturalistic in that they do not require researchers to directly interact with research volunteers', '… are readily accessible to researchers and easy to collect', '… are unaffected by the way social media platforms work']",['None of the above'],"['Presidential approval ratings', 'Health topics (e.g. spread of diseases)', 'Well-being and economic satisfaction']",-1,0,3,Ethical approve means researchers have followed standards that are meant to be followed in other to carry out a proper research,Completely acceptable,i'm very ok with the study especially with the results cos it achieved a positive aim at the end,,Somewhat acceptable,,,Somewhat acceptable,,,Completely acceptable,,,Extremely important,Moderately important,Extremely important,Very important,Moderately important,Slightly important,Slightly important,Very important,Very important,,5.0,3.0,1.0,2.0,6.0,4.0,7.0,,,,,,
459,True,1017.0,Facebook,50.0,Female,White / Caucasian,Bachelor's degree,Very conservative,Not at all aware,"['… are large and can contain millions of data points', '… reflect events in real-time and can be collected continuously over time', '… are naturalistic in that they do not require researchers to directly interact with research volunteers', '… often capture social relationships not found using traditional methods (e.g. surveys)', '… are readily accessible to researchers and easy to collect', '… are always representative of people’s offline behavior']","[""Publicly posting on users' profiles"", 'Creating fake accounts (""bots"")', 'Secretly changing the content of what users see']","['Political elections (e.g. voting behavior)', 'Economic forecasting', 'Presidential approval ratings', 'Health topics (e.g. spread of diseases)', 'Well-being and economic satisfaction', 'Public sentiment (e.g. environment-related concerns)', 'News consumption (e.g. sharing of misinformation)', 'Social networks']",2,1,8,"Conducting research in a way that is not hurtful, damaging, or offensive; and is morally upstanding.",Somewhat unacceptable,i'm not sure that replying to hate speech at all is acceptable,,Somewhat acceptable,i don't see anything too harmful; however not sure about sending an unsolicited message from a bot though?,,Completely acceptable,,"the subjects accepted participating in the study, so they were consensual participants",Completely acceptable,,i think it was acceptable; the researchers were just encouraging twitter users to check the facts of something that was tweeted,Very important,Not at all important,Extremely important,Slightly important,Very important,Moderately important,Very important,Very important,Slightly important,"cannot be hurtful, manipulative, or immoralunethical",7.0,4.0,5.0,6.0,1.0,3.0,2.0,"must maintain morality, be unbiased, legal and ethical",1.0,,,,
460,True,1028.0,Facebook,38.0,Male,White / Caucasian,Master's degree or above,Very conservative,Very aware,"['… are large and can contain millions of data points', '… reflect events in real-time and can be collected continuously over time', '… are naturalistic in that they do not require researchers to directly interact with research volunteers', '… often capture social relationships not found using traditional methods (e.g. surveys)', '… are readily accessible to researchers and easy to collect']","['Privately messaging users', ""Publicly posting on users' profiles""]","['Political elections (e.g. voting behavior)', 'Economic forecasting', 'Presidential approval ratings', 'Health topics (e.g. spread of diseases)', 'Well-being and economic satisfaction', 'Communication (e.g. spread of opinions and hate-speech)', 'Public sentiment (e.g. environment-related concerns)', 'News consumption (e.g. sharing of misinformation)', 'Social networks']",3,2,9,It means that the study is reviewed and approved with little to no implications for the research subjects.,Completely acceptable,,,Completely acceptable,,,Completely acceptable,,,Completely acceptable,,,Very important,Moderately important,Extremely important,Slightly important,Moderately important,Slightly important,Moderately important,Very important,Very important,,5.0,7.0,3.0,4.0,2.0,6.0,1.0,,,,,,
461,True,884.0,Twitter,36.0,Female,White / Caucasian,Master's degree or above,Neutral/ Neither conservative or liberal,Not at all aware,"['… are large and can contain millions of data points', '… reflect events in real-time and can be collected continuously over time', '… often capture social relationships not found using traditional methods (e.g. surveys)', '… are readily accessible to researchers and easy to collect']",['None of the above'],"['Political elections (e.g. voting behavior)', 'Presidential approval ratings', 'Health topics (e.g. spread of diseases)', 'Well-being and economic satisfaction', 'Communication (e.g. spread of opinions and hate-speech)', 'News consumption (e.g. sharing of misinformation)']",2,0,6,I think ethical approval has to do with the risks the participants are subjected to within a study,Somewhat unacceptable,no knowledge of a study and no compensation what kind of hate speech was included in the study? just from one political side or both?,,Completely unacceptable,the participants were not aware that they were part of a study the initial invite is misleading because it is from a bot there was no compensation the data is completely unusable because it does not explore misinformation of the left-leaning nature,,Somewhat acceptable,i think the payoff vs collection of data is too small that sort of invasion of privacy over 8 weeks is worth more than $5,,Neutral,bot accounts participants not aware of the study being conducted and their data being collected,,Very important,Not at all important,Very important,Very important,Very important,Extremely important,Extremely important,Moderately important,Extremely important,,5.0,2.0,3.0,4.0,1.0,7.0,6.0,,8.0,,,,
462,True,911.0,Reddit,44.0,Male,White / Caucasian,Highschool,Slightly liberal,Slightly aware,"['… are large and can contain millions of data points', '… reflect events in real-time and can be collected continuously over time', '… often capture social relationships not found using traditional methods (e.g. surveys)', '… are readily accessible to researchers and easy to collect', '… are unaffected by the way social media platforms work']","['Privately messaging users', 'Creating fake accounts (""bots"")']","['Political elections (e.g. voting behavior)', 'Economic forecasting', 'Presidential approval ratings', 'Health topics (e.g. spread of diseases)', 'Well-being and economic satisfaction', 'Communication (e.g. spread of opinions and hate-speech)', 'Public sentiment (e.g. environment-related concerns)', 'News consumption (e.g. sharing of misinformation)', 'Social networks']",1,2,9,"I would assume it means they have to lay out exactly how they mean to obtain their data, the institution then ensure there's no immoral methods being used to collect data, and then the institution has to ""sign off"" on it. ",Somewhat acceptable,,,Somewhat acceptable,are the researchers also performing this exercise with left leaning users who share misinformation?,,Somewhat acceptable,"i don't like having an extension installed and being monitored, but the users were informed and agreed, they were also compensated",,Completely acceptable,,,Very important,Very important,Extremely important,Moderately important,Moderately important,Extremely important,Very important,Very important,Extremely important,"my main concerns were if the research was trying to curb improper behavior, and were the participants notified they were being studied",5.0,6.0,4.0,2.0,1.0,3.0,7.0,,8.0,,9.0,,10.0
463,True,948.0,Facebook,49.0,Male,African-American,Highschool,Neutral/ Neither conservative or liberal,Very aware,"['… reflect events in real-time and can be collected continuously over time', '… are naturalistic in that they do not require researchers to directly interact with research volunteers', '… often capture social relationships not found using traditional methods (e.g. surveys)', '… are readily accessible to researchers and easy to collect']","['Privately messaging users', ""Publicly posting on users' profiles""]","['Political elections (e.g. voting behavior)', 'Health topics (e.g. spread of diseases)', 'Communication (e.g. spread of opinions and hate-speech)', 'News consumption (e.g. sharing of misinformation)']",2,2,4,"Ethical approval is a component of the research process, which purpose is to protect both the researcher and the participants in the research that should have their dignity, rights, safety, and welfare respected.",Completely unacceptable,,,Neutral,,,Somewhat acceptable,,,Somewhat unacceptable,,,Extremely important,Very important,Extremely important,Not at all important,Slightly important,Very important,Extremely important,Extremely important,Extremely important,,6.0,1.0,3.0,5.0,2.0,7.0,4.0,,,,,,
464,True,1867.0,Facebook,69.0,Female,White / Caucasian,Highschool,Neutral/ Neither conservative or liberal,Not at all aware,"['… are large and can contain millions of data points', '… reflect events in real-time and can be collected continuously over time', '… are naturalistic in that they do not require researchers to directly interact with research volunteers', '… are readily accessible to researchers and easy to collect']",['Privately messaging users'],"['Well-being and economic satisfaction', 'Communication (e.g. spread of opinions and hate-speech)', 'News consumption (e.g. sharing of misinformation)']",2,1,3,I think it means that they are doing it legally and not lying about their motives. ,Completely acceptable,"if you are not posting derogatory or mean or bullying comments, i don't think it would be unacceptable",,Somewhat acceptable,"i feel that if the participants did not to share their views, whether to a real person or research study, they would not have answered",i'm still not sure if i feel that it is unethical or not to not give the participants the real information that this is a study,Completely acceptable,the participants were fully aware of the fact that this was a study and that their information was being used,"the people involved knew the real motives of the researchers and were fully aware that their information would be used for this purpose, and i feel it was very ethical",Somewhat acceptable,i feel that there was nothing wrong with it since they used factual information,"as long as no disrespect or unkind remarks or comments were used, it would seem fine",Very important,Moderately important,Moderately important,Moderately important,Moderately important,Moderately important,Very important,Very important,Very important,"i don't really have too much concerns as long as personal data is not used in a way that could identify any of the participants i'm not sure how i feel about people not knowing they are involved with a study, but they are willing to post information otherwise not knowing who is looking at it",7.0,1.0,6.0,2.0,3.0,5.0,4.0,,,,,,
465,True,2195.0,Facebook,75.0,Female,White / Caucasian,Highschool,Very conservative,Slightly aware,"['… are large and can contain millions of data points', '… reflect events in real-time and can be collected continuously over time', '… often capture social relationships not found using traditional methods (e.g. surveys)', '… are readily accessible to researchers and easy to collect']",['Privately messaging users'],"['Political elections (e.g. voting behavior)', 'Economic forecasting', 'Health topics (e.g. spread of diseases)', 'Well-being and economic satisfaction']",2,1,4,What they use must be ethical and not fake. ,Completely acceptable,i think it was a good thing if it made people post less hate speech,,Somewhat acceptable,maybe they could have the people know they were participating in a research study,,Completely acceptable,i don't see anything wrong with the study this is the same thing we do when we do these studies on prolific,,Somewhat acceptable,a lot of false information was on social media back when the vaccine for covid was raging maybe this would have helped more if people had known they were in a research study,,Extremely important,Slightly important,Extremely important,Very important,Moderately important,Moderately important,Extremely important,Moderately important,Moderately important,,7.0,4.0,3.0,2.0,5.0,6.0,1.0,,,,,,
466,True,1728.0,Twitter,35.0,Male,Asian - Indian,Master's degree or above,Slightly conservative,Very aware,"['… are large and can contain millions of data points', '… reflect events in real-time and can be collected continuously over time', '… are naturalistic in that they do not require researchers to directly interact with research volunteers', '… often capture social relationships not found using traditional methods (e.g. surveys)', '… are readily accessible to researchers and easy to collect']","['Privately messaging users', ""Publicly posting on users' profiles"", 'Creating fake accounts (""bots"")', 'Secretly changing the content of what users see']","['Political elections (e.g. voting behavior)', 'Economic forecasting', 'Presidential approval ratings', 'Health topics (e.g. spread of diseases)', 'Well-being and economic satisfaction', 'Communication (e.g. spread of opinions and hate-speech)', 'Public sentiment (e.g. environment-related concerns)', 'News consumption (e.g. sharing of misinformation)']",3,2,8,"In my opinion, getting ""Ethical approval"" to run a study means that the study must adhere to certain basic principles - such as respect of people's autonomy (do no harm), beneficence (minimize risk and maximize the potential of benefit) and justice (the benefits of the study should at least partially go to the subjects being studied) ",Somewhat unacceptable,"same as the previous study - twitter users' manipulation without their express informed consent is ethically unacceptable the only difference here is that instead of an automated bot, the replies were generated by anonymous human users, but that does not make it ethically acceptable","i would still say it is ethically unacceptable to do this without informed, valid consent of the 1000 twitter users",Completely unacceptable,"in my opinion - this is even worse than the first twitter study - sending unsolicited private messages to twitter users, without them giving informed consent to being part of an experimental study, is completely unethical this also brings up additional concerns about harassment (sexual or otherwise) through dms, etc","if i was on this university's irb, i would absolutely reject this study there is no amount of polishing that would convince me to approve this",Somewhat acceptable,"the browser extension installed to record the users' news website visits brings strong privacy concerns - what if there are other personal websites (such as tinder) being recorded accidentally as ""news"" websites? how long will these recordings be stored? will the data be secured?","information about how long the (browser extension) data would be stored, and who would have access to the data, whether it would be aggregated and anonymized - if these were laid out clearly and satisfactorily, would make the study ethically acceptable to me",Completely unacceptable,"in my opinion, this study is ethically unacceptable because participants were not even aware they were part of an experimental study even if the study objectives required that the participants not be told certain details (about the bot replying that the tweet is not true, and providing links to a fact-checking website) - at the very minimum the researchers should have informed the twitter users that they had been drawn into the study pool before using such manipulative tactics this is a shameful social experiment, and the university's irb should have rejected it","if i were on the irb board of this university - i would reject this study on ethical grounds, no matter what the study design is flawed",Slightly important,Not at all important,Slightly important,Slightly important,Moderately important,Very important,Extremely important,Moderately important,Slightly important,"whether the social media users have given their informed, valid consent to be part of the study - is the number one ethical concern other concerns are also important - such as for how long the researchers will store the data, who will have access to it, whether the data is aggregated and de-identified, etc",6.0,1.0,5.0,2.0,3.0,4.0,7.0,no major economic inducement to take part in the study,6.0,minimize threats to social media users mental health by the study manipulations,2.0,inform participants about the study's outcomes after the study has been concluded and analyzed,8.0
467,True,848.0,Facebook,33.0,Male,White / Caucasian,Bachelor's degree,Very conservative,Extremely aware,"['… are large and can contain millions of data points', '… reflect events in real-time and can be collected continuously over time', '… are naturalistic in that they do not require researchers to directly interact with research volunteers', '… are readily accessible to researchers and easy to collect']","['Privately messaging users', ""Publicly posting on users' profiles"", 'Creating fake accounts (""bots"")', 'Secretly changing the content of what users see']","['Political elections (e.g. voting behavior)', 'Economic forecasting', 'Presidential approval ratings', 'Health topics (e.g. spread of diseases)', 'Well-being and economic satisfaction', 'Communication (e.g. spread of opinions and hate-speech)', 'Public sentiment (e.g. environment-related concerns)', 'News consumption (e.g. sharing of misinformation)', 'Social networks']",2,2,9,"I think ethical approval means that the process by which the data is collected, the specific data collected, and the way that the data is stored is not indented to cause any individual any immediate or long lasting harm.",Neutral,,,Somewhat unacceptable,i always think that users should know that they are being studied and given an out,,Completely acceptable,"i have concerns about the privacy of the data collected, but the people had the choice to supply it and were given the option not to participate",,Somewhat unacceptable,i think it is not good when people do not know they are part of a study they should be told and given the ability to opt out,,Extremely important,Moderately important,Very important,Very important,Extremely important,Very important,Extremely important,Moderately important,Extremely important,,7.0,1.0,5.0,2.0,3.0,6.0,4.0,,,,,,
468,True,1180.0,Reddit,63.0,Male,White / Caucasian,Bachelor's degree,Slightly liberal,Moderately aware,"['… reflect events in real-time and can be collected continuously over time', '… are naturalistic in that they do not require researchers to directly interact with research volunteers', '… often capture social relationships not found using traditional methods (e.g. surveys)']",['None of the above'],"['Political elections (e.g. voting behavior)', 'Health topics (e.g. spread of diseases)', 'Well-being and economic satisfaction', 'Communication (e.g. spread of opinions and hate-speech)', 'News consumption (e.g. sharing of misinformation)']",3,0,5,Institutions have rules that ensure the proper manner for studies so that the institution retains its credibility.,Somewhat acceptable,,,Somewhat acceptable,,,Completely acceptable,,,Somewhat acceptable,,,Very important,Very important,Extremely important,Moderately important,Moderately important,Extremely important,Very important,Extremely important,Very important,,7.0,6.0,2.0,1.0,3.0,4.0,5.0,,,,,,
469,True,1410.0,Facebook,57.0,Female,White / Caucasian,Master's degree or above,Very liberal,Very aware,"['… are large and can contain millions of data points', '… reflect events in real-time and can be collected continuously over time', '… are naturalistic in that they do not require researchers to directly interact with research volunteers', '… often capture social relationships not found using traditional methods (e.g. surveys)', '… are readily accessible to researchers and easy to collect']","[""Publicly posting on users' profiles""]","['Political elections (e.g. voting behavior)', 'Presidential approval ratings', 'Health topics (e.g. spread of diseases)', 'Well-being and economic satisfaction', 'Communication (e.g. spread of opinions and hate-speech)', 'Public sentiment (e.g. environment-related concerns)', 'News consumption (e.g. sharing of misinformation)']",3,1,7,"It means that their institution has reviewed the research, and have determined that the research will not harm anyone, either emotionally or physically.",Neutral,"while this is partially not ethical because the participants weren't informed that they were part of a research project, i rated it neutral since it had a positive result of empathy and less hate speech",,Somewhat unacceptable,"i think that to be considered ethical, the participants need to be made aware that they are part of a research project","even though i consider it unethical, i rated it ""somewhat unacceptable"" rather than completely, because no harm was done by this research",Completely acceptable,"the participants were told that they were going to be part of a research study, so that part is ethical  they were also paid for their time",,Completely unacceptable,"for this to be considered ethical, participants should have been told that they were part of a research study","i rated it ""completely unacceptable"" because the experiment resulted in more language toxicity in tweets, which can be viewed as harmful",Not at all important,Not at all important,Slightly important,Not at all important,Not at all important,Not at all important,Extremely important,Moderately important,Not at all important,"whether or not the participant experiences any emotional or physical harm is a significant concern  for example, if a study participant sees imagesvideos of a crime scene as part of a study and then has nightmares about it for the long term, the participant has been harmed to a certain extent",6.0,2.0,7.0,3.0,1.0,4.0,5.0,i can't think of any additional factors not listed above,,,,,
470,True,1105.0,Reddit,32.0,Male,White / Caucasian,Highschool,Neutral/ Neither conservative or liberal,Not at all aware,"['… are large and can contain millions of data points', '… reflect events in real-time and can be collected continuously over time', '… are naturalistic in that they do not require researchers to directly interact with research volunteers', '… often capture social relationships not found using traditional methods (e.g. surveys)', '… are readily accessible to researchers and easy to collect']","['Privately messaging users', ""Publicly posting on users' profiles""]","['Political elections (e.g. voting behavior)', 'Health topics (e.g. spread of diseases)', 'Communication (e.g. spread of opinions and hate-speech)', 'Public sentiment (e.g. environment-related concerns)', 'News consumption (e.g. sharing of misinformation)', 'Social networks']",3,2,6,Simply the difference between right and wrong intrinsically known to mankind. We have a moral compass and they don't want to break any unspoken laws. i.e. its ok to collect data as long as its legal and noninvasive. ,Completely acceptable,"sometimes we lose ourselves in media and get passionate, maybe even radicalized a second opinion is all people need in order to rethink their position, cooler heads prevail taking data from public posts is completely acceptable, nobody got hurt","had they tracked those same users on their other social media platforms to see if their stance corroborated with stuff they post elsewhere, i suppose that could borderline be seen as stalking or of course somehow using illegitimate means to gain access to peoples dm's and stuff not shared publicly",Completely acceptable,"people love attention rather than feeling part of a statistic plus there's a human touch, when not being auto messaged by a robot i imagine they feel more enthusiastic to respond when they hadn't otherwise if proposed with a random poll like an advertisement somewhere on their feed",,Somewhat unacceptable,"seems a bit illegitimate to direct their attention to any one media outlet, rather than being an anonymous observer to collect truthful, unbiased and uninfluenced information but not that much so i think for $5 that's a total rip off, exposing yourself like that to prying eyes for such a long period and the choice between $5 or most likely $0considering the odds of a lottery is unfair they should get guaranteed money and entered into a lotteryb",,Somewhat unacceptable,,,Very important,Extremely important,Extremely important,Extremely important,Moderately important,Extremely important,Slightly important,Extremely important,Extremely important,,6.0,7.0,2.0,5.0,4.0,3.0,1.0,,8.0,,9.0,,10.0
471,True,915.0,Reddit,28.0,Male,African-American,Bachelor's degree,Neutral/ Neither conservative or liberal,Very aware,"['… are large and can contain millions of data points', '… reflect events in real-time and can be collected continuously over time', '… are naturalistic in that they do not require researchers to directly interact with research volunteers', '… are readily accessible to researchers and easy to collect']","['Privately messaging users', 'Creating fake accounts (""bots"")']","['Political elections (e.g. voting behavior)', 'Presidential approval ratings', 'Communication (e.g. spread of opinions and hate-speech)', 'Public sentiment (e.g. environment-related concerns)', 'News consumption (e.g. sharing of misinformation)', 'Social networks']",2,2,6,Approval based on adherence to moral or legal standards,Completely acceptable,,,Completely acceptable,,,Somewhat acceptable,,,Completely acceptable,,,Extremely important,Extremely important,Extremely important,Very important,Moderately important,Slightly important,Extremely important,Extremely important,Moderately important,,4.0,7.0,6.0,3.0,1.0,2.0,5.0,,,,,,
472,True,1293.0,Facebook,41.0,Female,White / Caucasian,Bachelor's degree,Slightly liberal,Slightly aware,"['… are large and can contain millions of data points', '… reflect events in real-time and can be collected continuously over time', '… are naturalistic in that they do not require researchers to directly interact with research volunteers', '… often capture social relationships not found using traditional methods (e.g. surveys)', '… are readily accessible to researchers and easy to collect']",['None of the above'],"['Communication (e.g. spread of opinions and hate-speech)', 'News consumption (e.g. sharing of misinformation)', 'Social networks']",3,0,3,I would assume it has much to do with confidentiality and etiquette.,Completely acceptable,"if hate speech is allowed on social media, that is where an ethical issue resides, not with the researchers if the profiles are public, it is not unethical",,Completely acceptable,"this was a better way to go about it, as people tend to want to share news and not be slammed for sharing fake news",,Somewhat acceptable,"as long as the participants were made completely aware of what the researchers had access to, i do not see an issue with it",,Completely acceptable,i think the researchers should have tweeted the facts instead of a link,"they should have announced themselves as researchers, especially if they really wanted to change the public opinion based on the misinformation tweeted",Very important,Moderately important,Moderately important,Moderately important,Moderately important,Very important,Moderately important,Very important,Very important,"when people have public profiles, they know what they are getting into",6.0,7.0,4.0,5.0,1.0,2.0,3.0,"importance of study as not to risk the many outcomes of online interaction that can be very negative, for a study about something that is not extremely important",1.0,interact as a researcher it will carry more weight if people know who is suggesting or informing and this does matter,10.0,,9.0
473,True,1385.0,Reddit,67.0,Male,White / Caucasian,Master's degree or above,Slightly liberal,Slightly aware,"['… are large and can contain millions of data points', '… reflect events in real-time and can be collected continuously over time', '… often capture social relationships not found using traditional methods (e.g. surveys)', '… are readily accessible to researchers and easy to collect']","['Creating fake accounts (""bots"")']","['Economic forecasting', 'Health topics (e.g. spread of diseases)', 'Well-being and economic satisfaction', 'Communication (e.g. spread of opinions and hate-speech)', 'Public sentiment (e.g. environment-related concerns)', 'News consumption (e.g. sharing of misinformation)', 'Social networks']",2,1,7,That the research doesn't violate academic standards of data collection (misrepresentations or inappropriate usage).   Probably requires approval by academic chair because the study represents the university so it must meet university standards.,Completely acceptable,understanding hate speech to me is an acceptable topic as long as responses do not contain hate speechna,,Completely acceptable,"another topic worth investigating, see no issue with the methodology",so long as the automated tweets were civil i see no issue,Somewhat acceptable,"i think it is okay not to disclose the purpose of a study, this study did not seem to violate standards",what was done with the information collected on individuals at end of study,Completely acceptable,understanding people who post false information is worth investigating,,Moderately important,Moderately important,Extremely important,Moderately important,Moderately important,Moderately important,Slightly important,Not at all important,Slightly important,"as long as the researchers do not send inappropriate information, i feel it is okay",5.0,6.0,4.0,1.0,2.0,7.0,3.0,,,,,,
474,True,1557.0,Reddit,48.0,Male,White / Caucasian,Bachelor's degree,Neutral/ Neither conservative or liberal,Moderately aware,"['… are large and can contain millions of data points', '… reflect events in real-time and can be collected continuously over time', '… are naturalistic in that they do not require researchers to directly interact with research volunteers', '… often capture social relationships not found using traditional methods (e.g. surveys)', '… are readily accessible to researchers and easy to collect']",['Secretly changing the content of what users see'],"['Political elections (e.g. voting behavior)', 'Economic forecasting', 'Presidential approval ratings', 'Health topics (e.g. spread of diseases)', 'Well-being and economic satisfaction', 'Communication (e.g. spread of opinions and hate-speech)', 'Public sentiment (e.g. environment-related concerns)', 'News consumption (e.g. sharing of misinformation)', 'Social networks']",3,-1,9,The researchers need to run their experiments with integrity and transparency.  The studies participants need to be voluntary and should be informed.  Their should be no risk or harm to anyone doing the studies.   All moral standards should be upheld when approving research.,Somewhat unacceptable,i have a concern that participants were not aware they were part of a research study  that could possibly be an ethical violation,,Somewhat unacceptable,i feel this kind of crosses the line a little bit and seems like it would be an ethical violation,,Completely acceptable,,,Somewhat acceptable,"again like the first post this one has participants unaware that they are part of a study, but maybe in this case it is acceptable?  you are replying back at obvious misinformation",,Very important,Very important,Moderately important,Slightly important,Very important,Moderately important,Moderately important,Very important,Very important,i think everything was pretty much covered in the topics above,6.0,3.0,7.0,4.0,2.0,5.0,1.0,,,,,,
475,True,2130.0,Reddit,34.0,Female,Mixed race,Bachelor's degree,Neutral/ Neither conservative or liberal,Moderately aware,"['… are large and can contain millions of data points', '… reflect events in real-time and can be collected continuously over time', '… are naturalistic in that they do not require researchers to directly interact with research volunteers', '… often capture social relationships not found using traditional methods (e.g. surveys)']",['Privately messaging users'],"['Communication (e.g. spread of opinions and hate-speech)', 'News consumption (e.g. sharing of misinformation)', 'Social networks']",4,1,3,Ethical approval means an internal review board has access to an approves the described means of performing a study. Ethical approval means there are no glaring errors in privacy retention and there is a willingness and knowledge of the participants present.,Somewhat unacceptable,"i don't think the researchers should have participated they should have classified what was already publicly available to meet those criteria of empathy and results i think the research points in a good direction though and technically may not have harmed anyone, just improved things emotionally and thus rationally for people",i would like to know the related institution that's supporting the research,Somewhat unacceptable,"this study is really interesting because it increased a person's self awareness, in that they went on to post higher quality news but, it's also creepy it gets into big brother territory and how further are we setting people up to fail by analyzing andor influencing behavior","i think it would be neat to ask voluntary participants to find examples of these things in their social media accounts and provide those to the researchers to analyze this way it will be more natural also, the researchers could classify the person and their beliefs towards seeking a balanced participant pool i don't know how they would do that other than describe the pool, but maybe there's a way",Neutral,,i would like to see a robust debriefing process or last part of the study that would educate participants about the benefits of being nonprejudiced in communicating about politics and interpreting the information that would increase how ethically acceptable i find it,Somewhat unacceptable,this study seems to be opposite in results to the previous one about empathy and hate speech,"i think it's more ethical to point to trueness or cause and effect if i knew these were contained studies, like how in the world did they choose who to get the hate speech from? was the selector more biased towards clear hate speech or certain ways the hate speech was said? because if there were differences in selection, there might be differences in results i can't take it as a more ethical study if i don't know for sure that there's no accidental bias i think it's ethical to uphold neutrality, because it's helpful to those seeking knowledge to not have to weed bias out",Slightly important,Moderately important,Very important,Very important,Not at all important,Extremely important,Extremely important,Very important,Slightly important,,3.0,2.0,4.0,1.0,6.0,7.0,5.0,,,,,,
476,True,1654.0,Facebook,78.0,Female,White / Caucasian,Bachelor's degree,Very conservative,Not at all aware,"['… are large and can contain millions of data points', '… reflect events in real-time and can be collected continuously over time', '… are naturalistic in that they do not require researchers to directly interact with research volunteers', '… often capture social relationships not found using traditional methods (e.g. surveys)', '… are readily accessible to researchers and easy to collect']","['Privately messaging users', ""Publicly posting on users' profiles"", 'Creating fake accounts (""bots"")']","['Political elections (e.g. voting behavior)', 'Economic forecasting', 'Presidential approval ratings', 'Health topics (e.g. spread of diseases)', 'Well-being and economic satisfaction', 'Communication (e.g. spread of opinions and hate-speech)', 'Public sentiment (e.g. environment-related concerns)', 'News consumption (e.g. sharing of misinformation)', 'Social networks']",3,3,9,"I would imagine it means the institution needs to be aware of the study, and assured it contains no illegal or immoral tactics to gain the information.",Completely acceptable,"i found this study to be  completely acceptable in that even though the participants were not aware of the deception, they did modify their behavior positively in some cases without coercion",,Somewhat acceptable,"again, thetwitter users' behaviors were somewhat modified positively by the private messages even though they werenot aware of the deception",,Completely acceptable,"this research was completely acceptable because the twitter users were aware of it, and were offered a compensation if they installed an extension",,Somewhat acceptable,"even though the tweets were part of a research study, the information they gave the twitter users was accurate, resulting in improved behavior",,Very important,Very important,Extremely important,Extremely important,Moderately important,Very important,Very important,Extremely important,Very important,"if the results of the research result in negative responses, i would be very concerned",7.0,3.0,6.0,5.0,1.0,2.0,4.0,,,,,,
477,True,890.0,Reddit,37.0,Male,Hispanic,Highschool,Very liberal,Slightly aware,"['… are large and can contain millions of data points', '… reflect events in real-time and can be collected continuously over time', '… are naturalistic in that they do not require researchers to directly interact with research volunteers', '… often capture social relationships not found using traditional methods (e.g. surveys)']","['Privately messaging users', 'Creating fake accounts (""bots"")']","['Political elections (e.g. voting behavior)', 'Presidential approval ratings', 'Health topics (e.g. spread of diseases)', 'Well-being and economic satisfaction', 'Communication (e.g. spread of opinions and hate-speech)', 'Public sentiment (e.g. environment-related concerns)', 'News consumption (e.g. sharing of misinformation)']",4,2,7,It means that they will get approved to do their study as long as they are not doing anything ethically or morally wrong like something that is unjust or would harm people.,Completely acceptable,i just think that if it reduces hate speech then it is a good study,,Somewhat acceptable,i think that it might not give the best results because it seems like the results could be due just to random chance,how long they were messaged or misled,Completely acceptable,i think the study is ethical and informative,,Somewhat acceptable,i am concerned that doing this might inform people on how to divide people more and make them do more hate speech,who they shared this information with and if it will lead to twitter doing things to lower hate speech,Moderately important,Moderately important,Extremely important,Moderately important,Moderately important,Slightly important,Very important,Extremely important,Moderately important,yes if it can potentially lead to harm to people or more division between people i think it is concerning especially if it gets in the wrong hands,5.0,7.0,4.0,6.0,2.0,1.0,3.0,,4.0,,9.0,cost vs benefits for study participants will they be compensated in some way?,10.0
478,True,2102.0,Reddit,38.0,Male,White / Caucasian,Bachelor's degree,Slightly liberal,Very aware,"['… are large and can contain millions of data points', '… reflect events in real-time and can be collected continuously over time', '… are naturalistic in that they do not require researchers to directly interact with research volunteers', '… often capture social relationships not found using traditional methods (e.g. surveys)']","['Privately messaging users', ""Publicly posting on users' profiles"", 'Creating fake accounts (""bots"")']","['Political elections (e.g. voting behavior)', 'Economic forecasting', 'Presidential approval ratings', 'Health topics (e.g. spread of diseases)', 'Well-being and economic satisfaction', 'Communication (e.g. spread of opinions and hate-speech)', 'Public sentiment (e.g. environment-related concerns)', 'News consumption (e.g. sharing of misinformation)', 'Social networks']",4,3,9,"It essentially means an ""okay"" from the IRB or ""Institutional Review Board"" that the study they're conducting is ""moral"" to some degree. Or at least it doesn't cross some sort of ethical boundaries.",Somewhat acceptable,,"i think you could argue that this seems somewhat manipulative also, by what measure was something deemed hate speech? it seems to be an ever expanding concept these days",Somewhat acceptable,,,Somewhat acceptable,,you could argue that this type of data collection is harmful to privacy,Somewhat acceptable,i don't really have any concerns as i see it as perfectly acceptable for the most part,"so called ""fact checkers"" are often bias and have been caught red handed in the past pushing false information you could argue that there's a chance that this type of study further produced additional ""misinformation"" into the public i also think that you could argue that this type of study adds ""fuel to the fire"" so to speak and further degrades public discourse",Very important,Slightly important,Very important,Moderately important,Slightly important,Moderately important,Extremely important,Slightly important,Moderately important,nothing that hasn't already been mentioned,6.0,3.0,5.0,1.0,4.0,7.0,2.0,is it bias against certain groups? -- is it targeting certain groups in a way that could be weaponized against them?,8.0,,,,
479,True,2298.0,Facebook,60.0,Male,White / Caucasian,Master's degree or above,Very conservative,Very aware,"['… are large and can contain millions of data points', '… reflect events in real-time and can be collected continuously over time', '… often capture social relationships not found using traditional methods (e.g. surveys)', '… are readily accessible to researchers and easy to collect']","['Privately messaging users', ""Publicly posting on users' profiles"", 'Creating fake accounts (""bots"")']","['Political elections (e.g. voting behavior)', 'Economic forecasting', 'Presidential approval ratings', 'Health topics (e.g. spread of diseases)', 'Well-being and economic satisfaction', 'Communication (e.g. spread of opinions and hate-speech)', 'Public sentiment (e.g. environment-related concerns)', 'News consumption (e.g. sharing of misinformation)', 'Social networks']",2,3,9,they need to get approval for the research so that it does not violate the ethical standards set up by the institution.  Must not violate research guidelines or norms.  They can't just start collecting data for no reason.,Neutral,"again the user had no knowledge that they were in a study, being deceived",i would be curious to see if those that knew they were part of a survey intentionally replied back in ways to skew the resutls,Neutral,the people involved did not know that they were in a study  they got the data they wanted but were being deceptive,,Completely acceptable,seems like participants were well informed of the project,,Neutral,people not aware that they were in a study and were deceived into thinking that they were dealing with real accounts,,Very important,Moderately important,Very important,Extremely important,Extremely important,Moderately important,Extremely important,Moderately important,Slightly important,awareness of respondents and real versus bots on the surveys part,6.0,1.0,5.0,2.0,4.0,7.0,3.0,,,,,,
480,True,1945.0,Twitter,27.0,Male,White / Caucasian,Bachelor's degree,Slightly liberal,Moderately aware,"['… are large and can contain millions of data points', '… are naturalistic in that they do not require researchers to directly interact with research volunteers', '… are always representative of people’s offline behavior']","['Privately messaging users', 'Secretly changing the content of what users see']","['Political elections (e.g. voting behavior)', 'Communication (e.g. spread of opinions and hate-speech)', 'News consumption (e.g. sharing of misinformation)', 'Social networks']",1,0,4,ethical approval has to do with established standards of how a research study should be carried out,Completely unacceptable,the consent of participants wasn't gotten,,Completely unacceptable,,,Somewhat unacceptable,"for one, the pay isn't encouraging there is also the issue of privacy i don't think i would be comfortable giving access to my social media accounts for that long",,Somewhat unacceptable,,,Slightly important,Slightly important,Slightly important,Extremely important,Not at all important,Extremely important,Extremely important,Slightly important,Moderately important,,5.0,1.0,4.0,3.0,7.0,2.0,6.0,,,,,,
481,True,2339.0,Facebook,57.0,Female,White / Caucasian,Associate's degree,Very conservative,Not at all aware,"['… are naturalistic in that they do not require researchers to directly interact with research volunteers', '… often capture social relationships not found using traditional methods (e.g. surveys)', '… are readily accessible to researchers and easy to collect']","['Creating fake accounts (""bots"")', 'Secretly changing the content of what users see']","['Political elections (e.g. voting behavior)', 'Economic forecasting', 'Presidential approval ratings', 'Health topics (e.g. spread of diseases)', 'Well-being and economic satisfaction', 'Communication (e.g. spread of opinions and hate-speech)', 'Public sentiment (e.g. environment-related concerns)', 'News consumption (e.g. sharing of misinformation)']",1,0,8,"Consistent gathered information (ideas, opinions, thoughts) from a wide range of demographics. To be considered ethical it would need to be collected without stealing, hacking, or deception. ",Completely unacceptable,"this is also deceptive although the outcome would be deemed positive, the participants were not aware that they were being manipulated",researchers should continue to find ways of improving behaviors (like reducing hate speech ) without manipulation,Completely unacceptable,"this was a deceptive practice because participants were not advised that this was part of a research study, the research team did not obtain permission from these people",,Completely acceptable,this was a fair study as long as the browser extension didn't manipulate the facebook content being shown example; i shop for contact lenses and the cookies on my browser now tell facebook to bombard me with contact lens advertisements,,Completely acceptable,"this would be acceptable if and only the fact checkers were indeed facts also, there should be a fact checking rebuttal allowed i have seen were supposed ""fact checkers"" were not actual facts","if this caused people to modify their behaviors in a positive way, it appears to be less deceitful this would be a better environment for social media platforms when bots interject random replies to something an algorithm has identified, then it looses its validity and trustworthiness at that point",Moderately important,Moderately important,Very important,Moderately important,Extremely important,Very important,Extremely important,Very important,Moderately important,"my concern is manipulation is this research going to be used for future use in manipulating peoples' opinions, thoughts, and behaviors? if it is accepted as a socially acceptable adjustment, what about other manipulations?",6.0,1.0,5.0,2.0,3.0,7.0,4.0,,8.0,,9.0,,10.0
482,True,1782.0,Facebook,42.0,Male,White / Caucasian,Associate's degree,Slightly liberal,Moderately aware,"['… are large and can contain millions of data points', '… often capture social relationships not found using traditional methods (e.g. surveys)', '… are readily accessible to researchers and easy to collect']","[""Publicly posting on users' profiles""]","['Political elections (e.g. voting behavior)', 'Health topics (e.g. spread of diseases)', 'Public sentiment (e.g. environment-related concerns)', 'News consumption (e.g. sharing of misinformation)', 'Social networks']",1,1,5,Ethical approval means that the researcher has to go by ethical standards,Somewhat acceptable,,,Somewhat acceptable,,,Somewhat unacceptable,i felt as if they bribed the participants,,Somewhat unacceptable,they used bots to conduct their research,,Moderately important,Very important,Very important,Moderately important,Moderately important,Moderately important,Very important,Very important,Very important,,4.0,2.0,6.0,3.0,1.0,7.0,5.0,"representation, make sure that you get data from a diverse pool of participants",2.0,,1.0,,1.0
483,True,1746.0,Facebook,36.0,Male,Hispanic,Associate's degree,Neutral/ Neither conservative or liberal,Very aware,"['… are large and can contain millions of data points', '… reflect events in real-time and can be collected continuously over time', '… are naturalistic in that they do not require researchers to directly interact with research volunteers', '… often capture social relationships not found using traditional methods (e.g. surveys)', '… are readily accessible to researchers and easy to collect']",['None of the above'],"['Political elections (e.g. voting behavior)', 'Economic forecasting', 'Presidential approval ratings', 'Health topics (e.g. spread of diseases)', 'Well-being and economic satisfaction', 'Communication (e.g. spread of opinions and hate-speech)', 'Public sentiment (e.g. environment-related concerns)', 'News consumption (e.g. sharing of misinformation)', 'Social networks']",3,0,9,they probably need to make sure no one is hurt or affected by the study. they need to prove that it is unbiased and fair. ,Completely acceptable,it doesnt seem like it would hurt anyone it was pretty straight forward no one was affected by it,,Somewhat acceptable,"the message was private, it was done without messaging them publicly",,Completely acceptable,it is a very fair study straight forward honest,to know how the extension works,Somewhat acceptable,they used reputable real fact checking sites they corrected bad information,i need to know which fact checking websites,Extremely important,Moderately important,Very important,Extremely important,Extremely important,Extremely important,Extremely important,Extremely important,Extremely important,if the private information of the user is used if they were tricked,6.0,5.0,4.0,2.0,1.0,7.0,3.0,give compensation rewards for studies gift cards,1.0,make sure the fack checking sites used arent biased or liberal biased,2.0,using different sites besides twitter,3.0
484,True,1648.0,Twitter,60.0,Male,White / Caucasian,Bachelor's degree,Slightly conservative,Very aware,"['… often capture social relationships not found using traditional methods (e.g. surveys)', '… are readily accessible to researchers and easy to collect']","['Creating fake accounts (""bots"")']","['Economic forecasting', 'Health topics (e.g. spread of diseases)', 'Well-being and economic satisfaction', 'Social networks']",0,1,4,I would think the research would need to be fact checked for accuracy to ensure there is not wild speculation contained in the research.  This would have be completed by a team assigned by the University.,Completely unacceptable,"an individual should always know if they are participating in a study, as it would be unethical for a company to gather that information without permission",,Completely unacceptable,"not sure i understand why you would send a private message to these twitter users to try and improve the quality of the news content  do you intend to that into perpetuity, as twitter users will revert back to their behavior prior to the testi also don’t like that individuals were not told they were participating in a study",why not tell them they are participating in a study  it would have the same outcome as the misleading approach you are using,Somewhat acceptable,,"i would like to know what was the criteria for that initial facebook targeted advertisement  use the typical demographic criteria and let people see who you sent it to, and ultimately who ended up participating",Completely unacceptable,"so what did you accomplish in that study? once again, you didn’t tell people they were part of a research study, so that negates the data that was secured",,Slightly important,Slightly important,Slightly important,Slightly important,Moderately important,Moderately important,Slightly important,Slightly important,Moderately important,"what is the goal of twitter other than being a bully pulpit  if the hope is to somehow change behavior or control the message, that’s never going to happen  if we truly believe in free speech, you have to let people say what they want  it’s up to each individual user as to whether they want to believe the information or move on  i think of it this way…if someone was giving a speech that was just full of inaccuracies and misinformation, we don’t cut them off  they are allowed to speak  as a listener, its up to the individual whether they want to listen to this information or turn the channel can’t sensor the information, right or wrong",3.0,2.0,1.0,5.0,4.0,7.0,6.0,,,,,,
485,True,597.0,Facebook,23.0,Female,White / Caucasian,Master's degree or above,Very liberal,Very aware,"['… are large and can contain millions of data points', '… reflect events in real-time and can be collected continuously over time', '… are naturalistic in that they do not require researchers to directly interact with research volunteers', '… are readily accessible to researchers and easy to collect']",['Secretly changing the content of what users see'],"['Political elections (e.g. voting behavior)', 'Economic forecasting', 'Presidential approval ratings', 'Health topics (e.g. spread of diseases)', 'Well-being and economic satisfaction', 'Communication (e.g. spread of opinions and hate-speech)', 'Public sentiment (e.g. environment-related concerns)', 'News consumption (e.g. sharing of misinformation)']",2,-1,8,Ethical approval usually comes from an institution's review board who reviews the researchers' experiment to ensure that they are not using unethical research methods or data collected in an unethical manner,Somewhat unacceptable,participants did not consent to the study,participants had no idea they were being studied and interacted with researchers,Completely unacceptable,participants have not consented to the study,,Somewhat acceptable,,,Somewhat unacceptable,participants did not consent to the study,,Not at all important,Not at all important,Not at all important,Slightly important,Not at all important,Not at all important,Extremely important,Moderately important,Moderately important,,7.0,3.0,5.0,4.0,2.0,6.0,1.0,,,,,,
486,True,1936.0,Facebook,41.0,Female,African-American,Highschool,Slightly liberal,Slightly aware,"['… are large and can contain millions of data points', '… reflect events in real-time and can be collected continuously over time', '… often capture social relationships not found using traditional methods (e.g. surveys)', '… are readily accessible to researchers and easy to collect', '… are unaffected by the way social media platforms work']","['Privately messaging users', 'Creating fake accounts (""bots"")', 'Secretly changing the content of what users see']","['Political elections (e.g. voting behavior)', 'Health topics (e.g. spread of diseases)', 'Well-being and economic satisfaction', 'Communication (e.g. spread of opinions and hate-speech)', 'Public sentiment (e.g. environment-related concerns)', 'News consumption (e.g. sharing of misinformation)', 'Social networks']",1,1,7,I think they have to get approval from more than one person/group.,Neutral,the researchers didn't tell them due to the nature of the study but could've informed them another way,,Neutral,i say neutral because the researchers had to hide some info in order to get an honest opinion,,Completely acceptable,they were informed about the study and took part as they wish,,Somewhat unacceptable,,,Very important,Very important,Extremely important,Extremely important,Very important,Extremely important,Very important,Extremely important,Moderately important,"all volunteers should be aware that they are taking part in a study, and the researcher can inform them in some way",7.0,1.0,5.0,3.0,2.0,6.0,4.0,,,,,,
487,True,1839.0,Reddit,49.0,Male,Asian - Eastern,Bachelor's degree,Slightly liberal,Moderately aware,"['… are large and can contain millions of data points', '… reflect events in real-time and can be collected continuously over time', '… are naturalistic in that they do not require researchers to directly interact with research volunteers', '… are readily accessible to researchers and easy to collect']",['Secretly changing the content of what users see'],"['Political elections (e.g. voting behavior)', 'Presidential approval ratings', 'Health topics (e.g. spread of diseases)', 'Well-being and economic satisfaction', 'Communication (e.g. spread of opinions and hate-speech)', 'Public sentiment (e.g. environment-related concerns)', 'News consumption (e.g. sharing of misinformation)', 'Social networks']",2,-1,8,Universities usually have an Ethics panel that approves these types of studies to make sure they follow a set of guidelines that are put in place to not harm the test subjects.,Somewhat acceptable,as long as they are human operated it seems acceptable to me even though the people they replied to did not know about the purpose of the replies,,Somewhat acceptable,i think it is necessary to have participants not know they are part of a study in order for the results to be more honest and valid,,Somewhat acceptable,getting people to take a survey thru an ad seem acceptable but i don't like the use of the browser extension i find it too invasive,,Somewhat unacceptable,replying to the accounts directly as if they were just a regular account is deceptive,it would have been more acceptable if the new accounts were honest and open about its purpose and stated that it was a fact-checking account rather than just a normal human-looking account,Moderately important,Moderately important,Very important,Very important,Very important,Moderately important,Slightly important,Very important,Moderately important,"just who is running the study, whether it is a university with an ethics board or a think-tank, partisan group that will use the results for nefarious ends",4.0,7.0,3.0,2.0,1.0,5.0,6.0,to be transparent and honest with their intentions and reasons for their study,3.0,,9.0,,10.0
488,True,1498.0,Twitter,69.0,Male,White / Caucasian,Master's degree or above,Very liberal,Moderately aware,"['… are large and can contain millions of data points', '… reflect events in real-time and can be collected continuously over time', '… are naturalistic in that they do not require researchers to directly interact with research volunteers', '… are readily accessible to researchers and easy to collect']","['Privately messaging users', 'Creating fake accounts (""bots"")']","['Political elections (e.g. voting behavior)', 'Health topics (e.g. spread of diseases)', 'Well-being and economic satisfaction', 'Communication (e.g. spread of opinions and hate-speech)', 'News consumption (e.g. sharing of misinformation)', 'Social networks']",2,2,6,"The institution believes that no harm will come to those impacted by the experiment, or if it's possible then clear notifications are given ahead of time and help is offered afterwards (such as a list of resources)",Somewhat unacceptable,participants were not aware they were part of a research study,i could see splitting the group in two and tell half of them that they're in an experiment i might like to see the account more identified (not totally anonymous)  in some of those cases,Somewhat unacceptable,participants were not aware they were part of a research study i'm not a fan of unsolicited messages either,,Completely acceptable,"it seems vastly underpaid, but i suppose you argue people aren't just doing it for the money",,Somewhat unacceptable,"it's not surprising that calling out people publicly hardens their position i think there's quite a bit of research on this ""human looking"" bot accounts are not something i want to encourage either","they should test with sending private messages and then compare the results to see if private messages are any more effective  but if bot accounts are sending them, that should be clearly indicated",Very important,Moderately important,Very important,Moderately important,Very important,Very important,Extremely important,Very important,Very important,how much people are paid if full disclosure is given,3.0,7.0,5.0,2.0,1.0,6.0,4.0,,,,,,
489,True,1004.0,Reddit,28.0,Male,African-American,Bachelor's degree,Slightly conservative,Not at all aware,"['… are large and can contain millions of data points', '… are readily accessible to researchers and easy to collect', '… are unaffected by the way social media platforms work']",['None of the above'],"['Political elections (e.g. voting behavior)', 'Communication (e.g. spread of opinions and hate-speech)']",-1,0,2,I think it has to do with laid down standards that are followed by researchers for a study to be conducted.,Completely acceptable,,,Completely acceptable,,,Completely acceptable,"at first i thought the web browser would be installed without their consent but reading through i realized it's completely with their knowledge, and they would possibly be rewarded for it, so i am ok with it",,Completely acceptable,,,Extremely important,Slightly important,Very important,Moderately important,Moderately important,Slightly important,Extremely important,Slightly important,Very important,,6.0,1.0,5.0,3.0,2.0,7.0,4.0,,,,,,
490,True,1925.0,Facebook,37.0,Female,White / Caucasian,Master's degree or above,Slightly liberal,Very aware,"['… are large and can contain millions of data points', '… reflect events in real-time and can be collected continuously over time', '… often capture social relationships not found using traditional methods (e.g. surveys)', '… are readily accessible to researchers and easy to collect']",['None of the above'],"['Political elections (e.g. voting behavior)', 'Economic forecasting', 'Presidential approval ratings', 'Health topics (e.g. spread of diseases)', 'Well-being and economic satisfaction', 'Communication (e.g. spread of opinions and hate-speech)', 'Public sentiment (e.g. environment-related concerns)', 'News consumption (e.g. sharing of misinformation)', 'Social networks']",2,0,9,That the researchers would use the acquired users data in an ethical manner without manipulating it. Keeping the users data safe and secure.,Somewhat acceptable,accounts were anonymous and operated by the human which is fine and the outcome was awesome so i would say that type of research is somewhat acceptable,,Somewhat unacceptable,creating fake accounts and sending unsolicited private messages to users is unethical,,Completely unacceptable,the researchers tried to bribe and manipulate the social media users,i do not approve this practice by the researchers,Somewhat unacceptable,creating fake accounts for research or any other purposes is not acceptable or ethical to me,,Very important,Very important,Extremely important,Extremely important,Extremely important,Very important,Extremely important,Extremely important,Extremely important,None,7.0,3.0,1.0,2.0,6.0,5.0,4.0,,,,,,
491,True,2554.0,Twitter,44.0,Male,African-American,Highschool,Slightly liberal,Moderately aware,"['… are large and can contain millions of data points', '… reflect events in real-time and can be collected continuously over time', '… are naturalistic in that they do not require researchers to directly interact with research volunteers', '… often capture social relationships not found using traditional methods (e.g. surveys)', '… are readily accessible to researchers and easy to collect']","['Privately messaging users', ""Publicly posting on users' profiles"", 'Creating fake accounts (""bots"")']","['Political elections (e.g. voting behavior)', 'Economic forecasting', 'Presidential approval ratings', 'Health topics (e.g. spread of diseases)', 'Well-being and economic satisfaction', 'Communication (e.g. spread of opinions and hate-speech)', 'Public sentiment (e.g. environment-related concerns)', 'News consumption (e.g. sharing of misinformation)', 'Social networks']",3,3,9,To be approved by the original source it came from.,Completely acceptable,"this should be done more often, it's a good thing to do, completely acceptable","hate speech is a serious issue, we need to do better",Somewhat acceptable,"i think it's in their best concerns to reduce the amount of misinformation, and also help fact check what's posted",it's acceptable on my behalf due to the researchers posting facts,Somewhat acceptable,"i can relate to going to another news source to see what information they're giving, and doing this study in this type of way is intriguing",,Neutral,"i'm not sure if this is good, or bad",,Extremely important,Extremely important,Extremely important,Extremely important,Very important,Extremely important,Very important,Extremely important,Extremely important,"who the researchers are targeting on social media sites race, sex, job type, political view",2.0,4.0,5.0,7.0,3.0,1.0,6.0,,,,,,
492,True,1450.0,Facebook,39.0,Female,White / Caucasian,Highschool,Slightly conservative,Extremely aware,"['… are large and can contain millions of data points', '… reflect events in real-time and can be collected continuously over time', '… are naturalistic in that they do not require researchers to directly interact with research volunteers', '… often capture social relationships not found using traditional methods (e.g. surveys)', '… are readily accessible to researchers and easy to collect']","['Privately messaging users', 'Creating fake accounts (""bots"")', 'Secretly changing the content of what users see']","['Political elections (e.g. voting behavior)', 'Presidential approval ratings', 'Health topics (e.g. spread of diseases)', 'Well-being and economic satisfaction', 'Communication (e.g. spread of opinions and hate-speech)', 'Public sentiment (e.g. environment-related concerns)', 'News consumption (e.g. sharing of misinformation)']",3,1,7,It means that possible risks have been considered and deemed acceptable.,Completely unacceptable,participants should have the right to accept or decline to participate in the study,,Completely unacceptable,participants should be made aware of the study and have the option to either accept or decline being included in it,,Completely acceptable,,,Completely unacceptable,the participants should have been made aware that they were part of a study and either accept or decline taking part in it,,Very important,Very important,Very important,Extremely important,Moderately important,Moderately important,Extremely important,Very important,Very important,,7.0,1.0,4.0,2.0,3.0,5.0,6.0,,,,,,
493,True,2782.0,Reddit,54.0,Male,White / Caucasian,Bachelor's degree,Neutral/ Neither conservative or liberal,Slightly aware,"['… are large and can contain millions of data points', '… reflect events in real-time and can be collected continuously over time', '… often capture social relationships not found using traditional methods (e.g. surveys)', '… are readily accessible to researchers and easy to collect']","['Privately messaging users', ""Publicly posting on users' profiles"", 'Creating fake accounts (""bots"")']","['Political elections (e.g. voting behavior)', 'Presidential approval ratings', 'Health topics (e.g. spread of diseases)', 'Well-being and economic satisfaction', 'Communication (e.g. spread of opinions and hate-speech)', 'Public sentiment (e.g. environment-related concerns)', 'News consumption (e.g. sharing of misinformation)', 'Social networks']",2,3,8,"Assurance that the experimenters will use the data and information collected only for the purpose explained in the study. Also, that the person being polled is aware of their rights and redresses, if necessary, by a board or body overseeing the researchers. Generally, that the experiment will cause no foreseeable harm to the people being polled.",Neutral,"it's concerning that the study misrepresented the nature of the anonymous accounts who replied to the message it's understandable that they wanted sincere reactions to the messages they sent and that informing the recipients they weren't real people could have caused the messages to be disregarded or met with a level of denial, but since there were a range of responses to the original hate speech, i wonder if any of the replies were incendiary, which could cause the original user to get even more emotionally involved, stressed, or angry, which could lead to actual violence or emotional distress i'd imagine if they were trying to measure how people reacted to different messages they would have to have them grouped into at least empathetic, neutral, and contrary types of messages the researchers sent","it's hard to judge without seeing the actual content of the messages, so i'd want to see that and who is overseeing the study and how closely it's being monitored",Somewhat acceptable,"same as the others, that the subjects were unaware of the experiment i do find the anonymous accounts more acceptable than the human-looking automated accounts",,Completely acceptable,,"it seems the study was forthcoming and transparent and that participants had to opt in to join it, so i can't see any issues, as long as all other processes are in place (eg the study is being overseen, etc)",Somewhat acceptable,"while most of the study seems innocuous, for instance, the bot is just replying with a tweet about fact-checking that the user can choose not to click, it's always concerning when the subjects don't know they're part of an experiment and that the automated accounts were apparently made to look like a human user",i'd want to make sure the study is only using publicly-made twitter statements and not going any further by looking into other social media sites the user might have linked or any other biographical information that could be discerned,Slightly important,Not at all important,Slightly important,Not at all important,Very important,Slightly important,Extremely important,Not at all important,Extremely important,,7.0,2.0,5.0,6.0,1.0,3.0,4.0,,,,,,
494,True,5027.0,Facebook,32.0,Male,White / Caucasian,Master's degree or above,Slightly conservative,Very aware,"['… are large and can contain millions of data points', '… reflect events in real-time and can be collected continuously over time', '… are naturalistic in that they do not require researchers to directly interact with research volunteers', '… often capture social relationships not found using traditional methods (e.g. surveys)', '… are readily accessible to researchers and easy to collect']","['Creating fake accounts (""bots"")']","['Political elections (e.g. voting behavior)', 'Economic forecasting', 'Presidential approval ratings', 'Health topics (e.g. spread of diseases)', 'Well-being and economic satisfaction', 'Communication (e.g. spread of opinions and hate-speech)', 'Public sentiment (e.g. environment-related concerns)', 'News consumption (e.g. sharing of misinformation)', 'Social networks']",3,1,9,Ethical approval means getting approval from the University or the government or both. ,Completely acceptable,,,Completely acceptable,,some people may not want to be contacted privately,Completely unacceptable,"choosing between the results of their own data or money is completely unacceptable why should participants have to pay to view their own data? they created it, so they should have access to it if they want it",,Completely acceptable,,,Very important,Very important,Very important,Slightly important,Very important,Extremely important,Very important,Extremely important,Extremely important,,7.0,2.0,5.0,1.0,4.0,3.0,6.0,,,,,,
495,True,2497.0,Facebook,35.0,Female,White / Caucasian,Bachelor's degree,Neutral/ Neither conservative or liberal,Moderately aware,"['… are large and can contain millions of data points', '… reflect events in real-time and can be collected continuously over time', '… often capture social relationships not found using traditional methods (e.g. surveys)', '… are readily accessible to researchers and easy to collect']","['Creating fake accounts (""bots"")', 'Secretly changing the content of what users see']","['Political elections (e.g. voting behavior)', 'Economic forecasting', 'Presidential approval ratings', 'Health topics (e.g. spread of diseases)', 'Well-being and economic satisfaction', 'Communication (e.g. spread of opinions and hate-speech)', 'Public sentiment (e.g. environment-related concerns)', 'News consumption (e.g. sharing of misinformation)', 'Social networks']",2,0,9,Approval to do any type of thing that might be deceptive.,Completely acceptable,,,Somewhat unacceptable,it seems a little too deceptive to me,,Completely acceptable,,,Completely acceptable,,,Moderately important,Moderately important,Very important,Very important,Very important,Very important,Extremely important,Very important,Very important,,6.0,5.0,4.0,1.0,3.0,7.0,2.0,,,,,,
496,True,781.0,Facebook,39.0,Male,White / Caucasian,Master's degree or above,Very conservative,Moderately aware,"['… reflect events in real-time and can be collected continuously over time', '… are naturalistic in that they do not require researchers to directly interact with research volunteers', '… often capture social relationships not found using traditional methods (e.g. surveys)', '… are readily accessible to researchers and easy to collect', '… are always representative of people’s offline behavior', '… are unaffected by the way social media platforms work']","[""Publicly posting on users' profiles""]","['Health topics (e.g. spread of diseases)', 'Well-being and economic satisfaction', 'Communication (e.g. spread of opinions and hate-speech)', 'Public sentiment (e.g. environment-related concerns)', 'News consumption (e.g. sharing of misinformation)', 'Social networks']",0,1,6,It has to with researchers taking a mental note of the standards meant to be followed while conducting research experiment.,Completely acceptable,,,Somewhat acceptable,,,Somewhat acceptable,,,Completely acceptable,,,Extremely important,Slightly important,Extremely important,Moderately important,Slightly important,Extremely important,Extremely important,Slightly important,Very important,i can't think of any other aspects,7.0,3.0,2.0,4.0,1.0,5.0,6.0,,,,,,
497,True,2915.0,Facebook,37.0,Female,African-American,Highschool,Very liberal,Not at all aware,"['… often capture social relationships not found using traditional methods (e.g. surveys)', '… are readily accessible to researchers and easy to collect']","['Creating fake accounts (""bots"")']","['Political elections (e.g. voting behavior)', 'Communication (e.g. spread of opinions and hate-speech)', 'News consumption (e.g. sharing of misinformation)', 'Social networks']",0,1,4,I think ethical approval means that institutions have to deem the experiments as tests that most would approve of.,Completely acceptable,,,Completely acceptable,,,Completely acceptable,,,Completely acceptable,,,Not at all important,Not at all important,Not at all important,Not at all important,Not at all important,Not at all important,Slightly important,Not at all important,Not at all important,,7.0,4.0,6.0,3.0,1.0,2.0,5.0,,,,,,
498,True,3180.0,Reddit,23.0,Female,African-American,Highschool,Slightly liberal,Slightly aware,"['… are large and can contain millions of data points', '… often capture social relationships not found using traditional methods (e.g. surveys)', '… are readily accessible to researchers and easy to collect']","['Privately messaging users', ""Publicly posting on users' profiles""]","['Political elections (e.g. voting behavior)', 'Economic forecasting', 'Presidential approval ratings', 'Well-being and economic satisfaction', 'Communication (e.g. spread of opinions and hate-speech)', 'Public sentiment (e.g. environment-related concerns)', 'News consumption (e.g. sharing of misinformation)', 'Social networks']",1,2,8,"I think ethical approval means that the experiment has to be deemed as appropriate, safe, and not have long-term consequences. ",Somewhat unacceptable,it is unacceptable that the users were never made aware that it was a study and the researcher analyzed the user's behaviors for weeks,,Somewhat unacceptable,it is good that the researchers only examined data that was collected during the experiment period but unacceptable that the users were messaged privately and were not made aware that it was a experiment,,Somewhat acceptable,it is good that users were made aware that it was a study and what the users had to do was related to the research topic,,Neutral,it is good that the researchers only analyzed the users' behaviors for a short period after the experiment but it is not appropriate that the researchers never told the users that it was an experiment,,Slightly important,Not at all important,Not at all important,Extremely important,Not at all important,Moderately important,Very important,Very important,Moderately important,,6.0,2.0,7.0,3.0,4.0,5.0,1.0,long-term effects of the experiment,4.0,,,,
499,True,3577.0,Twitter,55.0,Male,White / Caucasian,Vocational training,Very liberal,Moderately aware,"['… are large and can contain millions of data points', '… reflect events in real-time and can be collected continuously over time', '… are naturalistic in that they do not require researchers to directly interact with research volunteers', '… often capture social relationships not found using traditional methods (e.g. surveys)', '… are readily accessible to researchers and easy to collect']","['Privately messaging users', ""Publicly posting on users' profiles"", 'Creating fake accounts (""bots"")']","['Political elections (e.g. voting behavior)', 'Presidential approval ratings', 'Communication (e.g. spread of opinions and hate-speech)', 'Public sentiment (e.g. environment-related concerns)', 'News consumption (e.g. sharing of misinformation)', 'Social networks']",3,3,6,I think ethical approval is that an academic experiment is run in an ethical way. Meaning that the researchers adhere to ethical standards.,Somewhat unacceptable,the fact that participants were not aware they were part of a research study is a concern,,Somewhat unacceptable,i find it somewhat unacceptable that researchers sent unsolicited private messages,if the researchers had contacted the twitter users instead of sending unsolicited private messages i would probably find it a little more ethical,Completely acceptable,,,Somewhat unacceptable,the users were not informed that they are part of an academic research and deceived by human looking automatic accounts,,Moderately important,Not at all important,Moderately important,Moderately important,Moderately important,Very important,Extremely important,Slightly important,Moderately important,,7.0,1.0,3.0,2.0,5.0,6.0,4.0,,,,,,
